source	target
{0}  If you choose to continue, you may not have access to some of your old data. 	Иацышәҵар шәҭахызар, ажәытә дыррақәа ԥыҭк  рахь  анеира азин шәцәыӡыр шәылшоит
%1$s   <small>%2$s</small>	%1$s   <small>%2$s</small>
© 2011 Red Hat, Inc. © 2011-2020 The Contacts Developers	© 2011 Red Hat, Inc. © 2011-2020 Аимадарақәа рыҟаҵаҩцәа
© 2018-2020 Juan Pablo Ugarte, et al. © 2004-2018 Tristan Van Berkom, Juan Pablo Ugarte, et al. © 2001-2006 Joaquin Cuenca Abela, Paolo Borelli, et al. © 2001-2006 Ximian, Inc.	© 2018-2020 Хуан Пабло Угарте (Juan Pablo Ugarte) уб.егь. © 2004-2018 Тристан Ван Берком (Tristan Van Berkom), Хуан Пабло Угарте (Juan Pablo Ugarte) уб.егь. © 2001-2006 Joaquin Cuenca Abela, Paolo Borelli, уб.егь. © 2001-2006 Ximian, Inc.
3 × 3 1 minute	3 × 3        1 минуҭк
%.3f atm	%.3f атм
4 × 4 3 minutes	4 × 4        3 минуҭк
4 × 4 5 minutes	4 × 4        5 минуҭк
5 × 5 15 minutes	5 × 5        15 минуҭ
5 × 5 5 minutes	5 × 5        5 минуҭк
Abandon this game to start a new one?	Ари ахәмарра кажьны аҿыц шәалагар шәҭахума?
%A %B %-d	%A, %-d %B
%A, %B %e	%A, %e %b
%A, %B %e %H:%M	%A, %e %b. %H:%M
%A, %B %e %H:%M:%S	%A, %e %b. %H:%M:%S
%A, %B %e %l:%M %p	%A, %e %b. %I:%M:%p
%A, %B %e %l:%M:%S %p	%A, %e %b. %I:%M:%S %p
%a %b %-e_%R	%a, %-e %B_%R
%a %b %-e_%R:%S	%a, %-e %B_%R:%S
%A %B %e %Y	%A, %-d %B %Y
%A, %B %e, %Y	%A, %e %b. %Y
%A, %B %e, %Y %H:%M	%A, %e %b. %Y %H:%M
%A, %B %e, %Y %H:%M:%S	%A, %e %b. %Y %H:%M:%S
%A, %B %e, %Y %l:%M %p	%A, %e %b. %Y %I:%M %p
%A, %B %e, %Y %l:%M:%S %p	%A, %e %b. %Y %I:%M:%S %p
abstract	ахҳәаа
A bytestring, type ‘ay’	Абаиттә цәаҳәа, ахкы 'ay'
A byte (unsigned), type ‘y’	баитк (дыргада), ахкы 'y'
Achromatomaly (blue cone monochromacy)	Ахроматомалиа (аԥштәы агәынкылара ацәыӡра ииаҵәоу аколбахәыҷқәа рыла)
Achromatopsia (monochromacy)	Ахроматопсиа ( аԥштәы агәынкылара ацәыӡра)
Achum	Ачум
Action Attributes	Аҟаҵара аҟазшьарбагақәа
Active	Иаҿакуп
%a %d %b	%a, %d %b
%A %d %B	%A, %d %b
%a %d %b %Y	%a, %d %b. %Y
%a, %d %B %Y	%A, %d %b. %Y
%A %d %b %Y	%A, %d %b. %Y
%a, %d %B %Y  %X	%A, %d %b. %Y  %X
Afghanistan	Афганистан
Agnes	Агнэс
%a %H∶%M	%a, %H:%M
Ahom	Ахом
Ahoskie	Ахоски
Airplane Mode On	Авиарежим аҿакуп
AisleRiot web site	Веб-асаит Аислериот
Alaska	Алиаска
All day:	Амш зегьы:
All Day	Амш зегьы
_All files	_Афаилқәа зегьы
All files	Афаилқәа зегьы
All Files	Афаилқәа зегьы
All Files (*)	Афаилқәа зегьы(*)
All Glade Files	Афаилқәа зегьы Glade
All PKCS12 files	Афаилқәа зегьы  PKCS12
All _Upper Case	Хыхьтәи_арегистр ахь
_All	_Зегьы
All	Зегьы
%a %l∶%M %p	%a %H:%M
Altitude	Аҳаракыра
Always	Еснагь
Amapá / East Pará	Амапа / Амрагыларатә Пара
Amapala	Амапала
Amapá	Амапа
Amarillo	Амарилло
Amazonas	Амазонас
Ambler	Амблер
%a %m/%d/%Y %H:%M:%S	%a, %d.%m.%Y %H:%M:%S
%a %m/%d/%Y %I:%M:%S %p	%a, %d.%m.%Y %I:%M:%S %p
American Samoa	Америкатә Самоа
Amharic (EZ+)	Амхартәи (EZ+)
Amiens	Амьен
Ami	Ами
Amplitude of heads trembling (GMR-head) in running mode	Ахы(GMR-ахы) аҵысҵысра амплитуда еиҭаҵуа арежим  аҟны
Anadyr'	Анадырь
Anaheim	Анахаим
Anaktuvuk Pass	Анкчувек Пасс
Analysing audio files	Абжьтәы фаилқәа ранализ
Analysing files	Афаилқәа ранализ
Analysing "%s"	Анализ «%s»
Analysing track %02i	Абжьымҩахәасҭа анализ  %02i
Analysing video files	Авидеонҵамҭа анализ
Analyze	Анализҟаҵара
Anapa	Анапа
Anápolis	Анаполис
an arabic factorial symbol	Арабтә символ факториал
An archive cannot be called “..”.	Архив иамазар ҟалаӡом хьӡыс«..».
An archive cannot be called “.”.	Архив иамазар ҟалаӡом хьӡыс «.».
Anatol Drlicek	Анатоль Дрличек (Anatol Drlicek)
Anatolian Hieroglyphs	Анатолиатә иероглифқәа
An audio or video stream is not handled due to missing codecs. You might need to install additional plugins to be able to play some types of movies	Аудио- мамзара авидео еишьҭаҵа анаԥхгара амаӡам акодекқәа рыҟымзаара иахҟьаны.Иҟалап, афильмқәа рыхкқәа рҿакразы ишьақәыргылатәуп иацу амодульқәа.
An automatically saved version of `%s' is more recent.  Would you like to load the autosave version instead?	Автоматикла еиқәырхоу аверсиа "%s"  еиҳа иҿыцуп. Ишәҭахума шәара иара ацынхәрас автоматикла аиқәырхара змоу аверсиа ҭажәгалар. 
Anchorage	Анкоридж
Ancona	Анкона
Andravída	Андравида
Andrews	Андриус
Andria	Андриа
and	амперсанд
A newer file with the same name already exists in “%s”.	Еиҳа иҿыцу афаил ари аҩыза ахьӡ змоу ыҟоуп «%s» аҟны
A newer folder with the same name already exists in “%s”.	Еиҳа иҿыцу аҭаӡ ари аҩыза ахьӡ змоу ыҟоуп «%s» аҟны
Angeles	Анжелес
Ängelholm	Ангехольм
Ange_l	_Амаалықь
Angle Inlet	Англе-Инлет
Angleton	Англетон
Angola	Ангола
Anhui	Аньхои
Aniak	Аниак
Animism	Анимизм
Ankara	Анкара
Ankarena	Анкарена
Ankeny	Анкени
Annaba	Аннаба
Annapolis	Аннаполис
Ann Arbor	Анн-Арбор
Annette	Аннетт
Anniston	Аннистон
An older file with the same name already exists in “%s”.	Еиҳа иажәу афаил ари аҩыза ахьӡ змоу ыҟоуп «%s» аҟны
An older folder with the same name already exists in “%s”.	Еиҳа иажәу аҭаӡ ари аҩыза ахьӡ змоу ыҟоуп «%s» аҟны
Anonymous access denied	Ахьӡыдоу аҭалара мап ацәкуп
Anony_mous identity	И_хьӡыдоу ахаҭареилкаара
anonymous	ихьӡыдоу
Anonymous	Ихьӡыдоу
Áno Síros	Ано-Сирос
Antakya	Антакьиа
Antalya	Анталиа
Antananarivo	Антананариво
Antarctica/Casey	Антарктида/Кеиси
Antarctica	Антарктида
Antarctica	Антарктика
Antigo	Антиго
Antigua and Barbuda	Антигуеи Барбудеи
antique white	антикатә ашкәакәа
Antofagasta	Антофагаста
Antsiranana	Антисарана
An unsigned long integer, type ‘t’	Адырга змам идуу еибгоу ахыԥхьаӡара, ахкы 't'
Anvik	Анвик
Anything	Зегьы
Any time	аамҭарбада
Aomori	Аомори
Aosta	Аоста
Apache 2.0	GPL 2.0
Apache License, Version 2.0	Apache License, Аверсиа 2.1
Apalachicola	Апаличикола
Aperture	Апертура
Apia	Апиа
apostrophe	аиҟәыҭхага
App Chooser Button Attributes	Апшьы алхра апытҟәыр аҟазшьарбагақәа
A_ppearance	_Аԥшра
Appearance	Аԥшра
Appleton	Аплтон
April	Мшаԥымза
Apr	Мшаԥ
Arabic Grade 1	Арабтә аҩаӡара
Arabic	Арабтә
Aracaju	Аракаиу
Arad	Арад
%a %R	%a, %R
'Ar'ar	Арар
Áraxos	Арахос
Àrbatax	Арбатакс
Arcade	Аркадақәа
Arcata	Арката
Archi_ve Folder:	Архив_тә ҭаӡ:
Archive is encrypted	Архив шифрркуп
Archive Mail	Аԥошьҭа архивтәра
Archive selected directories using this format:	Иалху аҭаӡқәа ари аформат алхны архивтәра :
Archive this folder using these settings:	Уажәтәи аҭаӡ архивтәра абарҭ архиаракәа шәхы иархәаны:
Archive	Архив
ARCHIVE	АРХИВ
_Archive…	_Архивтәра...
Arctic/Longyearbyen	Арктика/Лонгир
Arctic Village	Арктик Виллидж
Ardabil	Ардебиль
Ardmore	Ардмор
Arequipa	Арекипа
Are you sure you want to convert the event into a message?	Шәара агәра ганы шәыҟоума ахҭыс ацҳамҭа ахь еиҭашәкыр шышәҭаху?
Are you sure you want to convert the memo into a message?	Шәара агәра ганы шәыҟоума азгәаҭа ацҳамҭа ахь еиҭашәкыр шышәҭаху?
Are you sure you want to convert the message into a meeting?	Шәара агәра ганы шәыҟоума ацҳамҭа аизара  ахь еиҭашәкыр шышәҭаху?
Are you sure you want to convert the task into a message?	Шәара агәра ганы шәыҟоума аҳасабтә ацҳамҭа ахь еиҭашәкыр шышәҭаху?
Are you sure you want to discard the message, titled “{0}”, you are composing?	Аус здыжәуло ацҳамҭа «{0}» анышәхыр шышәҭаху агәра ганы шәыҟоума?
Are you sure you want to discard the message you are composing?	Аус здыжәуло ацҳамҭа анышәхыр шышәҭаху агәра ганы шәыҟоума?
Arezzo	Ареццо
Argostólion	Аргостолион
[ARGS…]	[АҴАҴӶӘҚӘА…]
Argument not defined for zero	Аҵаҵӷәы арбаӡам ноль азы
_Arguments:	_Аҵаҵӷәқәа:
Arguments	Аҵаҵӷәқәа
Arguments: 	Аҵаҵӷәқәа:
Argument to “%s” is not a valid command: %s	Аҵаҵӷәы «%s» азы изин змоу  дҵаӡам : %s
Argument used to execute programs in the terminal defined by the “exec” key. DEPRECATED: This key is deprecated and ignored. The default terminal and how to invoke it is handled in GIO.	Аҵаҵӷәы, ахархәара змоу апрограммақәа атерминал арыд  "exec" ала иарбахо рыҟаҵаразы.ИАЖӘХЬОУ:ари ацаԥха ажәит,насгьы азхьаԥшра амаӡам.Атерминал ишыҟоу еиԥш, насгьы ааԥхьаршьа аус адулахоит GIO аҟны.
Arica	Арика
Arizona	Аризона
Arkadelphia	Аркадельфиа
Arkansas	Арканзас
Arkhangel'sk	Архангельск
Arlington	Арлингтон
Armenia	Ермантәыла
Armilla	Армилла
Ar Ruqayyiqah	Ар Рувкаииквах
%a %R:%S	%a, %R:%S
Artesia	Артижа
As check _pattern	Ахацтә _дәы аԥшра аҭаны
Ascoli Piceno	Асколи Пичено
Aspen	Аспен
Assiniboia	Ассинибоиа
Astana	Астана
Asti	Асти
Astoria	Асториа
Astrakhan'	Астрахань
Astronomical Units	Астрономиатә акака
Astronomy	Астрономиа
Asunción	Асуньсон
Aswan	Асуан
asymptotically equal to	асимптотикала иҟалоит
Asyut	Асиут
'Ataq	Атак
Athena	Афина
Athens	Афинақәа
Athlone	Атлон
Atlanta	Атланта
Atlantic/Azores	Атлантика/Азоры
Atlantic/Bermuda	Атлантика/Бермудақәа
Atlantic/Canary	Атлантика/Канарақәа
Atlantic/Cape_Verde	Атлантика/Кеип Верде
Atlantic City	Атлантик-Сити
Atlantic/Faeroe	Атлантика/Фаеро
Atlantic/Jan_Mayen	Атлантикатә океан/о-в Иан-Маиен
Atlantic/Madeira	Атлантика/Мадера
Atlantic/Reykjavik	Атлантика/Реикиавик
Atlantic/South_Georgia	Атлантикатә океан/о-в Аладатәи Георгиа
Atlantic/Stanley	Атлантикатә океан/Стенли
Atlantic/St_Helena	Атлантика/Св.Елена
Atlantic Time, no DST (Eastern Quebec)	Атлантикатә аамҭа, апхынтәи ада (мрагыларатәи Квебек)
Atlantic Time	Атлантикатә аамҭа
Atlantic	Атлантик
Atlantic	Атлантика
Atogo	Атого
Atoka	Атока
['attachment','attaching','attached','enclosed']	['аттач','аҭаҵа','attachment','attaching','attached','enclosed']
Attack a face-down pile.	Идырым амацеизга шәажәла
Attackers on %s may trick you into doing something dangerous like installing software or revealing your personal information (for example, passwords, phone numbers, or credit cards).	Ижәыло %s шәыржьар ҟалоит, насгьы ишәыдыргалар ишәарҭоу акы аҟаҵара, иаҳҳәап апрограмма ақәыргылара, мамзар шәхатәы дыррақәа раарԥшра(Иаҳҳәап ажәамаӡа, аҭел аномер, мамзар акредиттә хсаала)
At Ta'if	Ат-Таиф
Attribute not specified	Аҟазшьарбага "%s" еилкааӡам
Attribute "%s" is invalid on <%s> element in this context	Аҟазшьарбага "%s" гхоуп <%s> аелемент аҟны ари аконтекст ала
Attribute "%s" repeated twice on the same <%s> element	Аҟазшьарбага "%s" ҩынтәны  еиҭаҟалеит ахәҭа <%s> аҟны
attributes: 	Аҟазшьарбагақәа:
ATTRIBUTES	АҞАЗШЬАРБАГАҚӘА
Attributes	Аҟашьарбагақәа
Atyrau	Атырау
Audio CD	Аудио CD
Audio DVD	DVD-Audio
Audio Output	Аудиоҭыҵра
Audio Player	Аудиорҳәага
Audio Track	Аудио амҩахәасҭа
Audio/Video	Аудио/авидио
Audio	Аудио
Auditable code	Аудио ззыруа акод
Augsburg	Аугсбург
Aurangabad	Аурангабад
Aurillac	Ауриллак
Authenticated	Зхаҭареилкаау
Authenticate proxy server connections	Апрокси-сервер ахь аҿакрақәа рхаҭареилкаара 
A_uthenticate	А_хаҭареилкаара
Authentication dialog was dismissed by the user	Ахаҭареилкаара ахархәаҩ ила мап ацәкын
Authentication failed: %s	Ахаҭареилкаара мҩаԥымсӡеит: %s
Authentication Failed	Ахаҭареилкаара иманшәаламкәа имҩаԥысит
Au_thentication	А_хаҭареилкаара
Authentication	Ахаҭареилкаара
Automatically save the project to an alternate file whenever the project is modified and the specified timeout elapses	Автоматикла апроект даҽа фаилк ахь лассы-лассы аиқәырхара  , апроект аԥсахраангьы. 
Available	Аҳа аҿы
A “vardict”, type ‘a{sv}’	"Авердикт ", ахкы  'a{sv}'
A variant, type ‘v’	Авариант, ахкы 'v'
A variation on poker with dice and less money.	Апокер  аҟамаҭелқәеи аԥарақәеи рыла ахәмарр ахкы.
a vertical strike	Гәҵәыла  аҵәаӷәара
Bacău	Бакау
Bad Axe	Бед-Акс
Bahia	Баиа
Bahraini Dinar	Бахреинтәи адинар
Bahrain	Бахреин
Baia Mare	Баиа-Маре
Baie-Comeau	Баи-Комиу
Baie-de-la-Trinité	Баи-дела-Тринити
Baie-Sainte-Catherine	Баи-Саинт-Катрин
Bainbridge	Баинбридж
Baja California Sur	Баиа Калифорниа Сур
Baja California	Баиа Калифорниа
Baku	Баку
Baldonnel	Балдоннел
Balinese	Балиатә
Balmaceda	Балмаседа
Balneário Camboriú	Балнеариу-Камбориу
Bamboo	Бамбу
Bamum	Бамум
Bancroft	Бенкрофт
Bandirma	Бандирма
Banff	Бенф
Banja Luka	Баниа-Лука
banner	абаннер
Baraboo	Бар-Харбор
Barahona	Барахона
Barajas	Барахас
Barbacena	Барбацена
Barbados	Барбадос
Barcelona	Барселона
Bar Harbor	Бар-Харбор
Barinas	Баринас
Bari	Бари
Barletta	Барретта
Barnaul	Барнаул
Barquisimeto	Баркисимето
Barra do Garças	Барра-до-Гарцас
Barranquilla	Барранкилиа
Barretts	Барретс
Barre	Барр
Barrow	Барроу
Bartlesville	Бартлсвилль
Bartow	Бартоу
Baseline	Абазатә цәаҳәа
Baseline:	Абазатә цәаҳәа:
Baseline	Абазатә цәаҳәақәа
Basel	Базель
Basename of the default keybinding theme used by gtk+.	 gtk+ ахархәара змоу, арыдқәа ишыҟоу еиԥш рыдҳәаларҭа атема абазатә хьӡы.
Basename of the default theme used by gtk+.	Ишыҟоу еиԥш gtk+ ахархәара змоу атема  абазатә хьӡы
base	абазатә
Basic Protection	Абазатә ҽацәыхьчара
Basic Security Protections	Абазатә ашәарҭадаратә уснагӡатәқәа
Basic	Абазатә
Basseterre	Бастер
Basse-Terre	Бас-Тер
Bastia	Бастиа
Batak	Батак
Batesville	Батсвилл
Bathurst	Батерст
Batna	Батна
Baton Rouge	Батон-Руж
Båtsfjord	Ботсфьорд
Bay City	Беи-Сити
Bay Saint Lawrence	Беи-Саинт-Лоурентс
%B %-d	%-d %B %Y
%b %d %H∶%M	%e %b., %H:%M
%b %d %l:%M %p	%b. %d %l:%M %p
%b %d %l∶%M %p	%-d %B %H:%M
%b %d %Y	%d %b. %Y
%b %d %Y	%-d %B %Y
%B %-d %Y	%-d %B %Y
%b %d %Y	%e %b. %Y
Beardmore	Беардмор
Beatrice	Биатрис
Beauceville	Босевиль
Beaufort force %.1f	%.1f абаллқәа аихшарба Боффорт ала
Beaufort	Бофорт
Beaumont	Бомонт
Beauport	Бопорт
Beauvais	Боваис
Beauvechain	Бовечан
Beaver Falls	Бивер-Фоллс
Beaver Harbour	Бивер-Харбор
Bechar	Бичар
%b %e	%-d %b
%b %e	%e %b
%b %e %H:%M	%e %b., %H:%M
%b %e %H:%M:%S	%e %b., %H:%M:%S
Belarus	Беларусь
Belém	Бетлехем
Belfast	Белфаст
Belgium Dutch Grade 1	Бельгиа голландиатәи аҩаӡара 1
Belgium	Бельгиа
Belgrade	Белград
Belize	Белиз
Bella Coola	Белла-Кула
Bellaire	Беллер
Belleville	Белвилль
Bellevue	Белвиу
%b %e %l:%M %p	%e %b., %l:%M %p
%b %e %l:%M:%S %p	%e %b., %l:%M:%S %p
Belo Horizonte	Белу-Оризонте
Bemidji	Бемиджи
Benares	Варанаши
Benevento	Беневенто
Bengali	Бенгальтәи
Benin	Бенин
Benners	Беннерс
Bennington	Беннингтон
Benson	Бенсон
Benton Harbor	Бентон-Харбор
Bentonville	Бентонвилль
%b %-e_%R	%a, %-e %B_%R
Berberati	Берберати
Berens River	Беренс Ривер
Bergamo	Бергамо
Bergen	Берген
Bergerac	Бержерак
Berkeley	Беркли
Berlevåg	Берлевог
Berlin	Берлин
Bermuda	Абермудқәа
Bern	Берн
Berriane	Берриан
%b %-e_%R:%S	%a, %-e %B_%R:%S
Bethel	Бетел
Bettles	Бетлс
Beverly	Беверли
%b %e, %Y	%-d %b %Y
%b %e %Y %H:%M	%e %b. %Y, %H:%M
%b %e %Y %H:%M:%S	%e %b. %Y, %H:%M:%S
%B %e %Y, %I∶%M∶%S %p	%e %B %Y, %H:%M:%S
%b %e %Y %l:%M %p	%e %b. %Y, %l:%M %p
%b %e %Y %l:%M:%S %p	%e %b. %Y, %l:%M:%S %p
Biarritz	Биариц
bibliography entry	Абиблиографиатә нҵамҭа
bibliography	абиблиографиа
Biella	Бьелла
Bielsko-Biala	Бельско-Биала
Bierset	Бирсет
Big board	Идуу аԥшранҵа
<big><b>The photo is too large</b></big> The recommended size for a photo on your key is %d × %d pixels.	<big><b>Аԥшранҵа амцхә идууп</b></big> адгаларатә рышәага аԥшранҵақәа  ацаԥхаҟны   — %d × %d акәаԥқәа.
<big><b>Tips:</b></big>   * Right-click over the treeview to add items.   * Press Delete to remove the selected item.   * Drag &amp; Drop to reorder.   * Type column is editable.	<big><b>Аҵаҳәарақәа:</b></big>   * Аҵлаҟны  аелемент ацҵаразы , аҵла аҵаҟа аҳәынапԥ арыӷьаратәи пытҟәыр шәақәыӷәӷәа.   * Иалкаау аелементқәа рныхразы шәақәыӷәӷәа Delete.   * Аелеменқәа реишьҭагылашьа аԥсахразы еиҭажәга урҭ аҳәынаԥ ала.   * Ахкы аиҵагыла ариашара ҟалоит.
Bigfork	Бигфорк
Big game	Идуу ахәмарра
Biggin Hill	Биггин-Хил
Big Piney	Биг-Пинеи
Big Rapids	Биг-Репидс
Big Spring	Биг-Спрингс
Bilbao	Бильбао
Billings	Биллингс
Billund	Биллунн
Biloxi	Билокси
Bindersleben	Биндерслебен
Binghamton	Бингментон
Bintulu	Бинтулу
Biography	Абиографиа
Birchwood	Бирчвуд
Birjand	Биржанд
Birmingham	Бирмингем
Bishkek	Бишкек
Bishop	Бишоп
Biskra	Бискра
Bismarck	Бисмарк
bisque	абиквиттә
Bistrita	Бистрица
Bizerte	Бизерта
Black Eagle	Блек-Игл
Blackpool	Блекпул
Black River	Блек-Ривер
Blacksburg	Блексбург
Blagoveschensk	Благовешьенск
blanched almond	аӡыршы иӡааху аминдаль
Blanc-Sablon	Бланк-Саблон
Block	Аидкыла
Bloemfontein	Блумфонтеин
_Blog:	_Аблог:
Blog	Аблог
Blog:	Аблог:
Bloomington	Блумингтон
Bluefields	Блуфилдс
Bluefield	Блуфилд
Blue River	Блиу Ривер
Bluetooth enabled	Bluetooth аҿакуп
Bluetooth On	Bluetooth аҿакуп
Bluetooth RF kill	Bluetooth Rf kill
Blumenau	Блуменау
Blytheville	Блитевилл
Blythe	Блаит
Boat Basin	Боат-Базин
Boa Vista	Боа-Виста
Bodrum	Бодрум
Bogotá	Богота
Bogue	Бог
Bolivia	Боливиа
Bolle	Болле
Bologna	Болониа
Boltåsen	Болтасен
Bolzano	Больцано
Bol	Бол
Bom Jesus da Lapa	Бом-Иисус-да-Лапа
Bon Accord	Бон-Аккорд
Bonn	Бонн
Bonus if >62	Абонус , >62 акәзар
Boone	Бун
Bopomofo	Бопомофо
Bordeaux	Бордо
Borden	Борден
Borger	Боргер
Borlänge	Борленге
Boryspil'	Борисполь
Boscobel	Боскобель
Boscombe	Боскомбе
Bosnia and Herzegovina	Босниеи Герцеговинеи
Boston	Бостон
Botoşani	Ботошани
Botswana Pula	Ботсванская пула
Botswana	Ботсвана
Boukot Ouolof	Боукот-Оулоф
Boulder	Боулдер
Bournemouth	Борнмут
Bou Saada	Боу-Саада
Bow Island	Боу-Аиленд
Bowling Green	Боулинг-Грин
Bowman	Боумен
Box Elder	Бокс-Елдер
Boxes	Абоксқәа
Bozeman	Бозмен
Brahmi	Брахми
Braille	Браиль
Brainerd	Бреинерд
Branches	Амахәқәа
Branch	Амахә
Brandenburg	Бранденбург
Brandon	Брендон
Brasero media burning library	Абиблиотека Brasero аныҟәгага анҵаразы
Brasero optical media library	Абиблиотека Brasero аоптикатә ныҟәгага аус рыдуларазы
Brasero utilities library	Абиблиотека аутилит  Brasero
Brasília Time	Бразилиатәи аамҭа
Brasília	Бразилиа
Braşov	Брашов
Bratislava	Братислава
Bratsk	Братск
Braunschweig	Брауншвеиг
Bravo! You equalized your best score.	Аферым ! Шәара еиҟарашәтәит иреиӷьу шәылҵшәа.
Bravo! You finished the game again.	Аферым ! Шәара еиҭа ахәмарра шәахысит!
Bravo! You finished the game!	Аферым ! Шәара ахәмарра хшәырқәшеит!
Bravo! You improved your best score!	Аферым ! Шәара  иреиӷьыз шәылҵшәа еиҳа еиӷьышәтәит!
Bray	Бреи
Brazilian Portuguese	Бразилиатәи португалиатәи
Brazilian Real	Бразилиатәи реал
Brazil	Бразилиа
Brazzaville	Браззавиль
Bredeck	Бредек
Bremen	Бремен
Bremerton	Бремертон
Brenham	Бренхем
Brescia	Брескиа
Brest	Брест
Breuil-Cervinia	Бреул-Сервиниа
breve	бревис
Bridgeport	Бриджпорт
Bridgetown	Бриджтаун
Brighton	Браитон
Brindisi	Бриндизи
Brisbane	Брисбен
Bristol	Бристоль
British Columbia	Брианиатәи Колумбиа
British Indian Ocean Territory	Британиатәи аҵакырадгьыл Индиатәи аокеан аҟны
British Pound Sterling	Британиатәи  афунт стерлингқәа
British Virgin Islands	Британиатәи Вирджиниатәи адгьылбжьахақәа
Brive	Биве
Brize Norton	Бриз Нортон
Brno	Брно
Broadview	Бродвиу
broken bar	агәҵәытә цәаҳәа аиԥырҟьа аманы
Broken Bow	Брокен-Боу
Brønnøysund	Бронноизунд
Bronstein	Бронштеин
Brookings	Брукингс
Brooksville	Бруксвиль
Brooks	Брукс
Broome	Брум
Broomfield	Брумфилд
Browning	Браунинг
Brownsville	Браунсвиль
Brownwood	Браунвуд
Brunei Dollar	Брунеитәи адоллар
Brunei	Брунеи
Brunswick	Брунсвик
Brusque	Бруски
Bryce Canyon	Браис Каньон
<b>%s</b>: %s <b>%s</b>: %d×%d <b>%s</b>: %s	<b>%s</b>: %s <b>%s</b>: %d×%d <b>%s</b>: %s
Bucaramanga	Букараманга
Büchel	Биухель
Buckhannon	Бакханнон
Buckland	Бакленд
Bujumbura	Бужумбура
Bukoba	Букоба
Bulgarian Lev	Болгариатәи алым
Bulgaria	Болгариа
Bullhead City	Буллхед Сити
Bullsbrook	Буллсбрук
Burbank	Бербанк
Burley	Берли
Burlington	Берлингтон
Burnet	Барнет
Burns Lake	Бернс-Леик
Burns	Бернс
Butler	Батлер
Butte	Бьиутт
Button Attributes	Апытҟәыр аҟазшьарбагақәа
Buzău	Бузеу
byte,bytes,B	баит,абаитқәа,Б
BytesSourceSeqTimeUnits 	Абаитқәа       Ахықәкы        Азҵаалара        Аамҭа        Ашәара ак
Bytes	Абаитқәа
calendar:week_start:0	calendar:week_start:1
Caps lock is on.	Caps Lock  аҿакуп.
Caps Lock is on	Caps Lock аҿакуп
Caps Lock is on	Иаҿакуп арежим Caps Lock
CentOS	Centos OS
century,centuries	ашәышықәса, ашәышықәсақәа
Character Variants	Асимволқәа рвариантқәа
Character Variation 10	Асимвол 10 авариант
Character Variation 11	Асимвол 11 авариант
Character Variation 12	Асимвол 12 авариант
Character Variation 13	Асимвол 13 авариант
Character Variation 14	Асимвол 14 авариант
Character Variation 15	Асимвол 15 авариант
Character Variation 16	Асимвол 16 авариант
Character Variation 17	Асимвол 17 авариант
Character Variation 18	Асимвол 18 авариант
Character Variation 19	Асимвол 19 авариант
Character Variation 1	Асимвол 1 авариант
Character Variation 2	Асимвол 2 авариант
Character Variation 3	Асимвол 3 авариант
Character Variation 4	Асимвол 4 авариант
Character Variation 5	Асимвол 5 авариант
Character Variation 6	Асимвол 6 авариант
Character Variation 7	Асимвол 7 авариант
Character Variation 8	Асимвол 8 авариант
Character Variation 9	Асимвол 9 авариант
Cheese Website	Веб-асаит Cheese
Client Authentication	Аҭааҩ ихаҭареилкаара
Code Insight	Акод анализ
Combo Box Attributes	Иалшәо ахьӡынҵа аҟазшьарбагақәа
Combo Box Text Attributes	Иалшәо атекст ахьӡынҵа аҟазшьарбагақәа
Cookies	Cookie
Copyright © 2008-2013 Red Hat, Inc. Copyright © 2008-2013 David Zeuthen Copyright © 2009-2017 The GNOME Project 	Аԥҵаҩы изин © 2008-2013 Red Hat, Inc. Аԥҵаҩы изин © 2008-2013 David Zeuthen Аԥҵаҩы изин © 2009-2017 The GNOME Project 
Copyright © 2012 – 2021 Red Hat, Inc. Copyright © 2015 – 2018 Umang Jain	Аԥҵаҩы изин © 2012 – 2021 Red Hat, Inc. Аԥҵаҩы изин © 2015 – 2018 Umang Jain
Currencies	Авалиутақәа
Currency of the current calculation	Уажәтәи аихшьалара авалиута
Currency	Авалиута
cyan	ахаҳәиаҵәатә
Database	Адыррақәа рбаза
%d %b %Y	%d %b. %Y
%d-%b-%Y	%d-%b.-%Y
%d %B %Y	%d %b. %Y
(deadlock?) 	(анибакылара)
Default arguments are “-i -f %F -- %R”, where    %F — stands for the From address    %R — stands for the recipient addresses	Аҵаҵӷәқәа ишыҟоу еиԥш: «-i -f %F -- %R», уаҟа    %F — ашьҭҩы иҭыӡҭыԥ    %R — аиуаа рҭыӡҭыԥ
(Deprecated) Proxy authentication password	Аамҭалатәи ахаҭареилкаара аиԥырҟьара
(Deprecated) Proxy authentication user name	Аамҭалатәи ахаҭареилкаара аиԥырҟьара
Devhelp Website	Веб-асаит Devhelp
De_vilish	Иа_апку
Disk Usage Analyzer can scan specific folders, storage devices and online accounts. It provides both a tree and a graphical representation showing the size of each folder, making it easy to identify where disk space is wasted.	Адискқәа ранализҟаҵага азин амоуп хазытәи аҭаӡқәа рықәҭыхра, аиқәырхара аиҿыртәырақәа насгьы аҳасабырбатә нҵамҭақәа рықәҭыхра.Еиқәнаршәоит аграфикатә аарԥшра ,насгьы ҵлаҵас аарԥшра, аҭаӡцыԥхьаӡа ашәагаа шәзырбо , уи ишәнаҭоит алшара имарианы адиск аиужьра ахьыӡо ашьақәыргылара.
Disk Usage Analyzer	Адиск ахархәара анализҟаҵага
Display	Авидео
Display	Аԥшра
_Do not show this dialog again	_Ари ааиҿцәажәара уаҳа  иаарԥштәым
Do not show this message again	Ари ацҳамҭа уаҳа  иаарԥштәым
Do not _show this wizard again	Ари ацхырааҩ уаҳа  даарԥштәым
Don’t Warn Again	  Уаҳа  агәҽанымҵара
Dotless Forms	Икәаԥдоу аформақәа
Dotless Forms	Ицәаҳәеимҟьадоу Аформақәа
dotless %s	%s  кәаԥда
Do you want to continue?	Иацышәҵар шәҭахума?
Do you want to detach event from the series?	Ишәҭахума шәара ахҭыс асериа аҟынтә аҿыгара ? 
Do you want to reload this website?	Ари асаит  еиҭаҿашәкыр  шәҭахума?
Do you want to use GTK Inspector?	Шәхы иашәырхәар шәҭахума GTK Inspector?
Drop marble	Ампыл аршәра
dropped data	икажьу адыррақәа
Dropped Text.txt	Икажьу Текст.txt
Drop	Аршәра
DSL authentication	Ахаҭареилкаара DSL
Duration	Аамҭа
During a game	Ахәмарра аан
During game selection	Ахәмарра алхраан
DVD-R dual layer	DVD-R DL
Dynamic column header cleared.	Аамҭалатәи аиҵаргыла ахы рыцқьоуп.
Dynamic row header cleared.	Аамҭалатәи ацәаҳәа ахы рыцқьоуп.
East Amazonas	Амрагыларатәи Амазонас
Eastern Congo	Амрагыларатәи Конго
Eastern Greenland	Амрагыларатәи Гринландиа
Eastern Kazakhstan	Амрагыларатәи Казахстан
Eastern Mongolia	Амрагыларатәи Монголиа
Eastern Time (Queensland)	Амрагыларатәи  аамҭа(Квинсленд)
Eastern Time (Tasmania)	Амрагыларатәи  аамҭа (Тасманиа)
Eastern Time (Victoria)	Амрагыларатәи  аамҭа(Викториа)
Eastern Time	Амрагыларатәи  аамҭа
east	амрагыларатәи
East	Амрагыларатәи
%-e %b	%-e %B
%-e %b %H:%M	%-e %b. %H:%M
%-e %b %l:%M %p	%-e %b. %l:%M %p
%-e %b %Y	%-e %b. %Y
%-e %b %Y	%-e %B %Y
%e %B %Y	%e %b. %Y
%e %B %Y	%e %b., %Y
%-e %b %Y %H:%M	%-e %b. %Y %H:%M
%-e %b %Y %l:%M %p	%-e %b. %Y %l:%M %p
%e %B %Y, %R	%-d %B %Y, %R
Eight Off	аабақәа рыда
Embedded NUL byte in conversion input	Абаит  NUL аҵакы змоу аҭаларатә аиҭакра ззухо  дыррақәа рҟны
Embedded NUL byte in conversion output	Абаит  NUL аҵакы змоу аҭыҵратә аиҭакратә дыррақәа рҟны
Emojis	Emoji
enabled	Иаҿакуп
_Enabled	_Иаҿакуп
Enabled	Иаҿакуп
English (_US-ASCII)	Англыз(_US-ASCII)
Entire Journal	Ажурнал зегьы
ESlint	ESLint
Evening	ахәылбыҽха
Exec Arguments	Адәықәҵара аҵаҵӷәқәа
Exiting learn mode.	Аҭҵаара арежим аҟынтә аҭыҵра 
Exiting list notification messages mode.	 ардыррақәа  рыхьӡынҵа аҟынтә аҭыҵра
E	Аҟны
File &amp; Link Associations	Афаилқәеи азхьарԥшқәеи реидгыла
File Chooser Attributes	Афаил алхра аҟазшьарбагақәа
File & Link Associations	Афаилқәеи азхьарԥшқәеи реидгыла
Firmware attestation	Аҭаӡахра аттестациа азура
Flying Height	Ашьҭԥраара аҳаракыра
Font Button Attributes	Ашрифт змоу апытҟәыр аҟазшьарбагақәа
Font Chooser Attributes	Ашрифт алхра аҟазшьарбагақәа
Forever	Еснагь
Framework version	Фреимворк аверсиа
_Fullscreen	_Аекран зегьы иҭаӡо
Fullscreen	Аекран зегьы иҭаӡо
Gay Gordons	Илахҿыху Агордонқәа
GL Version	Аверсиа GL
GMR Head Amplitude	Амплитуда GMR-ахы
gnome-disk-utility %s UDisks %s (built against %d.%d.%d)	gnome-disk-utility %s UDisks %s (аизга %d.%d.%d аҟынтә)
GNOME version (1998):	Аверсиа GNOME (1998):
GNOME Version	Аверсиа GNOME
GNU Affero General Public License, version 3 or later	GNU Affero General Public License, аверсиа 3 мамзар еиҳа ихьшәоу
GNU General Public License, version 2 or later	GNU General Public License, аверсиа 2 мамзар еиҳа ихьшәоу
GNU General Public License version 3 or later	GNU General Public License аверсиа 3 мамзар еиҳа ихьшәоу
GNU General Public License, version 3 or later	GNU General Public License, аверсиа 3 мамзар еиҳа ихьшәоу
GNU General Public License version 3 or later	GNU General Public License аверсиа 3 мамзар еиҳа иҿыцу
GNU General Public License version 3 or later	GNU General Public License аверсиа 3 мамзар еиҳа иҿыцу 
GNU Lesser General Public License, version 2.1 or later	GNU Lesser General Public License, аверсиа 2.1 мамзар еиҳа ихьшәоу
GNU Lesser General Public License, version 3 or later	GNU Lesser General Public License, аверсиа 3 мамзар еиҳа ихьшәоу
greater than	 Еиҳа еиҳауп
greater	еиҳаны
Grid Attributes	Аихыршь аҟазшьарбагақәа
Grid view	Аихыршь аԥшра аҭаны
Gross Profit Margin	Азеиԥш хашәалахәы
GTK Version	Аверсиа GTK
%g%t%m%t%f	%d%t%g%t%m%t%f
Hardware address:%s 	Аппараттә ҭыӡҭыԥ:        %s
Hardware address:	Аппараттә ҭыӡҭыԥ:  
Hardware Address	Аппараттә ҭыӡҭыԥ
Hardware Airplane Mode is On	Аппараттә авиарежим аҿакуп
Hardware Airplane Mode	Аппараттә авиарежим
Hardware ECC Recovered	Аппараттә ариашара
Have you ever encountered a bug?	Ишәыхьхьома шәара зныкыр агха?
Headerbar Attributes	Апанель ахы аҟазшьарбагақәа
Height (in pixels) of the window.	Аԥенџьыр аҳаракыра пиксельла
Height of assistant window	Ацхырааҩ иԥенџьыр аҳаракыра
Height of main window	Ихадоу аԥенџьыр аҳаракыра
Height of the window in pixels	Аԥенџьыр аҳаракыра пиксельла
Height of the window in pixels.	Аԥенџьыр аҳаракыра пиксельла
Height of the window	Аԥенџьыр аҳаракыра
Height property	Аҳаракыра
height	Аҳаракыра
_Height	_Аҳаракыра
_Height:	_Аҳаракыра:
Height	Аҳаракыра
Height: 	Аҳаракыра:
HEIGHT	АҲАРАКЫРА
Hitori Website	Веб-асаит Хитори
honeydew	амускаттә шьынка шкәакәа
HTML bookmarks database could not be parsed: %s	Агәылаҵақәа  HTML рдыррақәа рбаза аимыхра ауам    : %s
Hungarian 8 dot computer	Венгриатәи 8- кәаԥкны иҟоу акомпиутер
Hungarian Forint	Венгриатәи афоринт
Hungarian Grade 1	Венгриатәи аҩаӡара 1
Hungarian Grade 2	Венгриатәи аҩаӡара 2
Hungary	Венгриа
Icon View Attributes	Адыргаҷа адгалара аҟазшьарбагақәа
Icon View	Адыргаҷақәа  рыԥшра рыҭаны
Idle	Аус ауӡом
Important Messages	Ихадоу
Important	Акырзҵазкуа
Important	Ихадоу
Inbox	Иаашьҭу
Includes %s, %s and %s.	%s, %s насгьы %s алаҵаны
Incoming	Иаашьҭу
IndexedDB databases	Адыррақәа рбаза IndexedDB
infinity	аҳәаадара
initial temporary item	Аамҭалатәи аелемент аҭагылазаашьа арбаразы
In Process	Апроцесс аҟны
In Progress	Апроцесс аҟны
input	Аҭалара
Input	Аҭалара
introduction	алагалара
Intro	Алагалара
is greater than or equal to	Еиҳаны ма еиҟараны
is greater than	 Еиҳа еиҳауп
ISO Speed	ISO
jack of clubs	валет треф
jack of diamonds	валет бубен
jack of hearts	Афурҭ агәыҟаԥшь
jack of spades	валет пик
jack	валет
Johnston Atoll (Hawaii Time)	Атол Джонстон (Гаваиатәи аамҭа)
JOKER	JOKER
Justification Alternates	Аҵаҵӷәыркра авариантқәа
J	аҟны
('', 'KNYC', nothing)	('', 'UUEE', nothing)
KP_Right	Арӷьарахь(кеипад)
_Large (20 × 15)	_Удуу (20 × 15)
Large Photo	Идуу аԥшранҵа
Large Toolbar	Амаругақәа рпанель  ду
Large	Идуу
Last month	Иаҳхысыз амз азы
Last year	Иаҳхысыз ашықәс азы
LCD (white LED backlight)	LCD (ишкәакәоу LED-арлашара)
Leading Jamo Forms	Ихадоу аформа Jamo
Leading Jamo Forms	Ихадоу аформа Джамо
leaving abstract.	аннотациа аҟынтә аҭыҵра.
leaving acknowledgments.	 Аҭабурақәа рыхьӡынҵа аҟынтә аҭыҵра
leaving afterword.	ашьҭахьажәа аҟынтә аҭыҵра
leaving appendix.	аԥшьы аҟынтә аҭыҵра
leaving banner.	абаннер аҟынтә аҭыҵра.
leaving bibliography.	абиблиогриа аҟынтә аҭыҵра.
leaving blockquote.	ацитатаагара аидкыла аҟынтә аҭыҵра.
leaving chapter.	ахы  аҟынтә аҭыҵра
leaving colophon.	аҭыҵратә дыррақәа рҟынтә аҭыҵра
leaving complementary content.	иацҵоу аҭаҵа аҟынтә аҭыҵра
leaving conclusion.	анҵәамҭа аҟынтә аҭыҵра.
leaving credits.	агәаларашәарақәа рҟынтә аҭыҵра
leaving credit.	агәаларашәара аҟынтә аҭыҵра
leaving dedication.	ахьӡынҩылара аҟынтә аҭыҵра
leaving endnotes.	анҵәамҭаҭә лбаагақәа  рҟынтә аҭыҵра.
leaving epigraph.	аепиграф аҟынтә аҭыҵра
leaving epilogue.	 аҵыхәтәажәа аҟынтә аҭыҵра
leaving errata.	агхақәа рыхьӡынҵа  аҟынтә аҭыҵра
leaving example.	аҿырԥштәы аҟынтә аҭыҵра 
leaving feed.	Алента аҟынтә аҭыҵра
leaving figure.	асахьа аҟынтә аҭыҵра 
leaving foreword.	аԥхьажәа аҟынтә аҭыҵра
leaving form.	аформа аҟынтә аҭыҵра
leaving glossary.	глоссари аҟынтә аҭыҵра
leaving index.	арбага аҟынтә аҭыҵра
leaving information.	Адыррақәа рҟынтә аҭыҵра 
leaving introduction.	аҭагалара  аҟынтә аҭыҵра
leaving list.	ахьӡынҵа аҟынтә аҭыҵра
leaving main content.	ихадоу аҭаҵа  аҟынтә аҭыҵра
leaving navigation.	ахырхарҭарбара  аҟынтә аҭыҵра
leaving page list.	 адаҟьақәа рыхьӡынҵа аҟынтә аҭыҵра
leaving panel.	апанель аҟынтә аҭыҵра
leaving part.	ахәҭа  аҟынтә аҭыҵра
leaving preface.	алагалажәа аҟынтә аҭыҵра.
leaving prologue.	алагалажәа аҟынтә аҭыҵра.
leaving pullquote.	ацитата аҟынтә аҭыҵра
leaving QNA.	азҵаарақәеи аҭакқәеи рҟынтә аҭыҵра.
leaving region.	аҵакыра аҟынтә аҭыҵра
leaving search.	аԥшаара аҟынтә аҭыҵра
leaving suggestion.	Ахеилак алҵра
leaving table of contents.	аҵакы аҟынтә аҭыҵра
leaving table.	аҭаӡҩыра аҟынтә аҭыҵра
Legacy BIOS _Bootable	_Legacy BIOS Bootable
Length	Аамҭа
Letters & Symbols	Анбанқәеи асимволқәеи
Letters	Анбанқәа
Level Bar Attributes	Апанель аҩаӡара аҟазшьарбагақәа
Libraries	Абиблиотекақәа
Library	Абиблиотека
List view	Ахьӡынҵа аԥшра аҭаны
_List View	Ахьӡынҵа_аԥшра аҭаны
List View	Ахьӡынҵа аԥшра аҭаны
_Login	_Аҭалара
Login	Аҭалара
Log Out %s	 %s ахархәаҩ иҭыҵра
Manual (via Actions menu)	Напыла (амениу  Аҟаҵара аҟынтә)
Manual	Напыла
Marietta	Mариетта
%m/%d	%d/%m
%m/%d/%y	%d.%m.%y
Meaningless key/value pair combination in address entry “%s”	Иҵакыдоу аилаҵа ацаԥха/ аҵакы аҭыӡҭыԥ «%s» аелемент аҟны
Media whitepoint	Аныҟәгага акәаԥ шкәакәа
MEI version	Аверсиа MEI
Menu Attributes	Амениу аҟазшьарбагақәа
Message Dialog Attributes	Аиҿцәажәара ацҳамҭа аҟазшьарбагақәа
Message Thread	Анҵамҭа амахә
Midway Atoll (Samoa Time)	Атолл Мидвей (Самоанатәи аамҭа)
Model Button Attributes	Амодель апытҟәыр аҟазшьарбагақәа
'Monospace 12'	«Monospace 12»
more information	Еиҳаны аинформациа
More Than	 Еиҳа еиҳауп
More	Еиҳаны
M_ost	_Еиҳарак
Most	Еиҳарак
Move right	Арӷьарахь
MTU:%s 	MTU:%s 
Multicast:%s 	Multicast:%s 
Multi_key	Multi key
[ {'name': <'DuckDuckGo'>, 'url': <'https://duckduckgo.com/?q=%s&t=epiphany'>, 'bang': <'!ddg'>}, {'name': <'Google'>, 'url': <'https://www.google.com/search?q=%s'>, 'bang': <'!g'>}, {'name': <'Bing'>, 'url': <'https://www.bing.com/search?q=%s'>, 'bang': <'!b'>} ]	[ {'name': <'DuckDuckGo'>, 'url': <'https://duckduckgo.com/?q=%s&t=epiphany'>, 'bang': <'!ddg'>}, {'name': <'Google'>, 'url': <'https://www.google.com/search?q=%s'>, 'bang': <'!g'>}, {'name': <'Bing'>, 'url': <'https://www.bing.com/search?q=%s'>, 'bang': <'!b'>} ]
navajo white	навахо шкәакәа
Navan	Ан-Уавь
Networks	Аҳа аҿы
No change	Ԥсахрада
No Desktop Background	Аусуратә ишәа адыԥшылахә ада
No Effect	Еффектда
No encryption	Ашифрркрада
No files in archive	Архив аҟны афаилқәа ыҟаӡам
No Filesystem	Афаилтә система ада
No grouping	аидыргәыԥларада
_No Image	_Сахьада
no justification	риашарада
No Label	Дыргада
No license	Лицензиада
No limit	Ԥкрада
No longer in use.	Уаҳа ахархәара аиуӡом.
No name	Хьӡыда
None - distributed internally	Лицензиада-аҩныҵҟатәи аҭаххарақәа рзы
no password	Ажәамаӡада
No Preference	Аиӷьашьарақәа рыда
No pre-filtering	Заанаҵтәи араӡарада
No problems have been detected with your connection.	Шәара шәеиԥшьырҭа аҟны апроблемақәа ԥшааӡам.
No profile	Аҷыдахәрада
No protection when the device is started.	Аиҿыртәара аҿакраан хьчарада
No Protection	Хьчарада
No proxy	Прокси ада
No redeals	Аиҭаҭарақәа рыда
No tab popup	Ицәырҵуа аҭаӡҩырартәрада
Notebook Attributes	Анҵамҭа шәҟәы аҟазшьарбагақәа
Not sorted	Аилыԥшаарада
Not tagged, file is not indexed	Дыргада, афаил аиндексркра азуӡамызт
No wireless available	Иҭелдоу аҳақәа ԥшааӡам
Num_Lock	Num Lock
On, fired	Иаҿакуп, аус ауит
Online	Аҳа аҿы
On This Computer A_rchive folder:	Архивтә ҭаӡ 'Ари акомпиутер аҟны'
on	иаҿакуп
On	Иаҿакуп
Out of paper	Ақьаад нҵәеит
output %s does not support mode %dx%d@%dHz	аҭыҵра %s иаднакылом арежим %dx%d@%dГц
Output	Аҭыҵра
Out	Аҭыҵра
Page_Down	Page Down
Page_Up	Page Up
Pansy	Адәыкрын
Paper	Ақьаад
partial fog	аамҭала анаҟә хылоит
Partial fog	Аамҭала анаҟә хылоит
PCRE library is compiled with incompatible options	Абиблиотека PCRE еизгоуп еимарам ахышәарақәа рыла
PCRE library is compiled without UTF8 properties support	Абиблиотека PCRE еизгоуп UTF-8 аҷыдаҟазшьақәа рмаҵурада
PCRE library is compiled without UTF8 support	Абиблиотека PCRE еизгоуп UTF-8 амаҵурада
PEAP _version	_Аверсиа PEAP
Permanently remove this folder	Ари аҭаӡ ихнымҳәуа  аныхра
Pick up and drop cards by clicking	Ақәыӷәӷәара ацхыраарала амацақәа ргара, мамзар рықәҵара  
Pixel Bytes	Апиксельқәа рбаитқәа
Places Sidebar	Аҭыԥ аваратәи апанель
PNG (lossless)	PNG (ахаҭабзиараҟны ацәыӡрақәа рыда)
Popover Attributes	Ихыло аелемент аҟазшьарбагақәа
prc3 Envelope	prc3
Print at	Аамҭа
Printer “%s” has no toner left.	Апринтер «%s» аҟны атонер нҵәеит
Printer “%s” is low on a marker supply.	Апринтер «%s» аҟны иԥштәылоу ашәыгаҭра анҵәара иаҿуп
Printer “%s” is low on at least one marker supply.	Апринтер «%s» аҟны атонерқәа руак анҵәара иаҿуп
Printer “%s” is low on developer.	Апринтер «%s» аҟны аарԥшыга анҵәара иаҿуп
Printer “%s” is low on paper.	Апринтер «%s» аҟны ақьаад анҵәара иаҿуп
Printer “%s” is low on toner.	Апринтер «%s» аҟны атонер  анҵәара иаҿуп
Printer “%s” is out of a marker supply.	Апринтер «%s» аҟны иԥштәылоу ашәыгаҭра нҵәеит
Printer “%s” is out of at least one marker supply.	Апринтер «%s» аҟны атонерқәа руак нҵәеит
Printer “%s” is out of developer.	Апринтер «%s» аҟны аарԥшыга нҵәеит
Printer “%s” is out of paper.	Апринтер «%s» аҟны ақьаад нҵәеит
Program Attributes	Апрграмма аҟазшьарбагақәа
Progress Bar Attributes	Анагӡара аиндикатор аҟазшьарбагақәа
Project "%s" has errors. Save anyway?	Апроект  «%s» аҟны иҟоуп агхақәа .Зегь акоуп еиқәырхатәума?
Project sidebar	Апроект аваратәи апанель
Project _Website	Веб-асаит _апроекта
Proximity Out	Иааигәаны
Quit mode	Арежим аҟынтә аҭыҵра  
Quit	Аҭыҵра
Revocation list signature	Анапаҵыҩрақәа рыхьӡынҵа  аԥыхра 
RF kill	Rf kill
RGB unit	Аидкыла RGB
right	Арӷьарахь
Right	Арӷьарахь
Roll all!	Зегьы аршәра!
Roll the dice	Аҟамаҭелқәа рыршәра
Roll	Аршәра
Roll!	Аршәра!
_Safely Remove Drive	_Ишәарҭамкәа аиҿартәыра алхра
_Safely Remove Drive	_Ишәарҭамкәа аусруга аныхра
Safely store a password or secret	Ишәарҭамкәа еиқәшәырха ажәамаӡа,мамзар амаӡа
Safe	Ишәарҭам
Sandbox escape	"аԥслымӡҭра" аҟынтә аҭыҵра
sans-serif %s	% аԥыҳәҳәақәа рыда
Sans	Аԥыҳәҳәақәа рыда
Scale Attributes	Аихшарба аҟазшьарбагақәа
Scale Button Attributes	Амасштабркра апытҟәыр аҟазшьарбагақәа
Scale Button	Агәҵәытә аихшарба
%s centuries	%s ашәышықәсақәа
Score	Акапан
_Script arguments	_Ақәныҟәа аҵаҵӷәқәа 
Scrollbar Attributes	Аҭаргьежьра апанель аҟазшьарбагақәа
Scrolled Window Attributes	Иҭаргьежьу аԥенџьыр аҟазшьарбагақәа
Scrolling Attributes	Аҭаргьежьра аҟазшьарбагақәа
Scroll_Lock	Scroll Lock
Search Base:	Аԥшаара абаза:
  Search for the Contact  or double-click here to create a new Contact.	Ишәыԥшаа аимадара , мамзар абраҟа шәақәыӷәӷәа аҿыц аԥҵаразы
  Search for the Contact.	Аимадара аԥшаара.
  Searching for the Contacts…	Аимадарақәа рыԥшаара...
Secondary click enabled	Аҩынтәтәи ақәыӷәӷәара аҿакуп
Secondary-Click	Аҩбатәи ақәыӷәӷәара
Secondary Icon Activatable	Аҩынтәтәи адырга иактивуп
Secondary Icon Pixbuf	Pixbuf аҩынтәтәи адырга 
Secondary Icon Sensitive	Аҩынтәтәи адырга анырра амоуп
Secondary Icon	Аҩынтәтәи  адырга
Secondary Stock Icon	Аҩынтәтәи  иҭаӡу адырга
Second Mouse Button	Аҳәынаԥ аҩбатәи  апытҟәыр
Se_cond zone:	Аҩбатәи_асааҭзона:
second	Аҩбатәи
Second	Аҩбатәи
Second:	Аҩбатәи алҵшәа:
Secure Boot disabled	Ишәарҭадароу аҭагалара аҿыхуп
Secure Boot enabled	Ишәарҭадароу аҭагалара аҿакуп
Secure Boot is Active	Ишәарҭадароу аҭагалара активуп
Secure Boot is Inactive	Ишәарҭадароу аҭагалара иактивым
Secure boot prevents malicious software from being loaded when the device starts.  For more information, contact the hardware manufacturer or IT support.	Ишәарҭадароу аҭагалара  аԥхасҭа ҟазҵо апрограмматә еиқәыршәарақәа рҭагалара  ԥнарҟәҟәоит  аиҿартәыра адәықәҵараан.  Иацҵаны аинформациа шәоурц азы амаруга аԥҵаҩы  ,мамзар ИТ -ацхыраара амаҵзура  шәрыдҵаала.
Secure boot	Ишәарҭадароу аҭагалара
Secure renegotiation is disabled	Ишәарҭам ҽазныктәи аиқәыршаҳаҭра  аҿыхуп
Secure Shell	Ишәарҭам ахарԥа
Sender Validation	Ашьҭҩы ивалидациа
Server Authentication	Асервер ахаҭареилкаара
%s has sent back the following assigned task response:	%s  ирхынҳәит анеҩстәи аҭак иарбоу адҵа ахь:
%s has sent back the following meeting response:	%s ирхынҳәит анеҩстәи аҭак аизара ахь:
%s Hotspot Active	Анеирҭа аҭыԥ  %s аҿакуп 
S_ick	И_чмазаҩу
Sidebar is visible	Иубарҭоу аваратәи апанель 
Side Bin	Аваратәи  аҭра
Side Bin	Аваратәи аҭра
Side by side	Еидгыланы
Similar	Аиԥш
%s is safe	«%s» ишәарҭам
slate gray	Ашифер цәыш аԥштәы
%s (library)	%s (абиблиотека)
<small>In memory of an extraordinary person and professor R.I.P Guido Macchi</small>	<small> Зеиԥш дҟамлац ауаҩԥси апрофессори игәаларшәара иазкны R.I.P. Гвидо Маки</small>
SMART _Attributes	Аҟазшьарбагақәа _SMART
<%s> must contain at least one <value>	 <%s> иамазароуп акы еиҳамзаргьы аҵакы <value>
[%s] Object class '<b>%s</b>' from %s %d.%d is deprecated 	Аобиект акласс '<b>%s</b>' %s %d.%d аҟынтә иажәхьеит
[%s] Object class '<b>%s</b>' was introduced in %s %d.%d 	[%s] Аобиект акласс '<b>%s</b>' ҭагалан %s %d.%d ахь
SOCKSv5 authentication failed due to wrong username or password.	Ахаҭареилкаара  SOCKSv5 хырқәшахеит иманшәаламкәа ахархәаҩ ииашам ихьыӡ мамзар иажәамаӡа амашала.
%s on chooser	%s алхраҟны
Sound & Video	Аудио насгьы авидео
[%s] Packing property '<b>%s</b>' of object class '<b>%s</b>' was introduced in %s %d.%d 	 [%s]«<b>%s</b>» архиара  аҷыдаҟазшьа  «<b>%s</b>» рыкласс иаҵанакуа аобиектқәа ҭагалан %s %d.%d ахь
Spin Button Attributes	Агьежьра апытҟәыр аҟазшьарбагақәа
spring green	Ааԥынтәи  аиаҵәара
[%s] Property '<b>%s</b>' of object class '<b>%s</b>' is deprecated 	[%s] Аҷыдаҟазшьа «<b>%s</b>» аобиект «<b>%s</b>» акласс  ажәит
[%s] Property '<b>%s</b>' of object class '<b>%s</b>' was introduced in %s %d.%d 	[%s]Аҷыдаҟазшьа «<b>%s</b>» аобиект «<b>%s</b>» акласс  иаҵанакуа ҭагалан %s %d.%d ахь
SRA4	SRA3
%s Run '%s --help' to see a full list of available command line options. 	%s  Аус ашәыруы  «%s --help» анеиразин ахьшәымоу адҵатә ҵәаҳәа  ахышәарақәа рыхҩылаақәа зегьы рыхәаԥшразы.
“%s”	«%s»
%s%s Encoding: %s %s	%s%s Акодркра: %s %s
%s%s Encoding: %s %s Substituting with <b>%s</b> (%s)	%s%s Акодркра: %s %s иԥсахуа  <b>%s</b> аҟынтә %s 
[%s] Signal '<b>%s</b>' of object class '<b>%s</b>' is deprecated 	«<b>%s</b>» асигнал   акласс иаҵанакуа аобиект «<b>%s</b>» ажәуп
[%s] Signal '<b>%s</b>' of object class '<b>%s</b>' was introduced in %s %d.%d 	[%s] «<b>%s</b>» асигнал   акласс иаҵанакуа аобиект «<b>%s</b>»ҭагалан %s %d.%d ахь
%s %s is no longer supported.	%s %s  уаҳа  иаднакылом
"%s": %s	«%s»: %s
%s,%s	%s, %s
%s: "%s"	%s: «%s»
%s,%s,%s	%s, %s, %s
Stack Attributes	Аиқәҵа аҟазшьарбагақәа
Stack Sidebar	Аиқәҵа аваратәи апанель 
Stack Switcher Attributes	Аиқәҵа аиагага аҟазшьарбагақәа
Start of Authority	Start of Authority (SOA)
Style Variant	Астиль авариант
Successfully checked out branch to working directory	Амахә иманшәаланы еиҭагоу аусуратә аизакхьӡынҵ ахь
_Suggestions:	_Авариантқәа:
Suggestions	Авариантқәа
Sum of the Years Digits Depreciation	Амортизациа Аицҵалыҵ-Ашықәсқәа-Аԥхьаӡацқәа
Sum-of-the-Years’-Digits Depreciation	Амортизациа Аицҵалыҵ-Ашықәсқәа-Аԥхьаӡацқәа
Sun	Амҽ
superscript 0	Хыхьтәи аиндекс 0
superscript 1	Хыхьтәи аиндекс акы
superscript 2	Хыхьтәи аиндекс ҩба
superscript 3	Хыхьтәи аиндекс хԥа
superscript 4	Хыхьтәи аиндекс 4
superscript 5	Хыхьтәи аиндекс 5
superscript 6	Хыхьтәи аиндекс 6
superscript 7	Хыхьтәи аиндекс 7
superscript 8	Хыхьтәи аиндекс 8
superscript 9	Хыхьтәи аиндекс 9
superscript a	Хыхьтәи аиндекс а
superscript equals	Хыхьтәи аиндекс иҟалоит
superscript left paren	Хыхьтәи аиндекс ахыц аартра
superscript minus	Хыхьтәи аиндекс минус
superscript n	Хыхьтәи аиндекс n
superscript plus	Хыхьтәи аиндекс плиус
superscript right paren	Хыхьтәи аиндекс ахыц аркра
superscript %s	Хыхьтәи аиндекс %s
superscript	Хыхьтәи аиндекс 
super	Хыхьтәи аиндекс 
Su	Амҽ
Synopsis	Ахҳәаа
Sys_Req	Sys Req
S	Аҟны
S	Амҽ
Tab Attributes	Агәылаҵакәа рҟазшьарбагақәа
Take notes and export them everywhere.	Азгәаҭақәа аанкыланы иахьакәзаалак аекспортра рзура
Teleport _Safely	_Ишәарҭам ателепортациа
Temporarily Disabled Until Tomorrow	 Аамҭала уаҵәынӡа иаҿыхуп
_Temporarily trusted (this session only)	_ Аамҭала зыгәрагоу (уажәтәи асеанс заҵәык азы)
Temporarily unable to resolve “%s”	 Аамҭала  «%s» азин аҭара ауам
Temporarily	Аамҭала
Temporary cached data	Аамҭала икешрку адыррақәа
Temporary files	Аамҭалатәи афаилқәа
Text attributes	Атекст аҟазшьарбагақәа
Text Attributes	Атекст аҟазшьарбагақәа
text-top	атекст ахы
Text View Attributes	Атекст адгалара аҟазшьарбагақәа
The “--alternative-start”, “--random-start” and “--usual-start” arguments are mutually exclusive.	Аҵаҵӷәқәа "--alternative-start", "--random-start" , "--usual-start" иеиҿагылоит.
The attribute "%s" was found twice on the <%s> element	Аҟазшьарбага "%s" ҩынтәны иԥшаан ахәҭа <%s> аҟны
The “--classic” and “--reverse” arguments are mutually exclusive.	Аҵаҵӷәқәа --classic и --reverse иеиҿагылоит.
The cover is open on printer “%s”.	Апринтер «%s» аҟны ахҩа аартуп
The door is open on printer “%s”.	Апринтер «%s» аҟны ашә аартуп
The following recipients were not recognized as valid mail addresses: {0}	Анаҩстәи адкылаҩцәа рԥошьҭақәа риашашьа еилкаамхазеит : {0}
The following recipient was not recognized as a valid mail address: {0}	Анаҩстәи адкылаҩ иԥошьҭа аиашашьа еилкаамхазеит : {0}
The height of the assistant window.	Ацхырааҩ иԥенџьыр аҳаракыра
The height of the main window in pixels.	Ихадоу аԥенџьыр аҳаракыра пиксельла
The height of the main window.	Ихадоу аԥенџьыр аҳаракыра
The height of the video captured from the camera, in pixels	Акамера(пиксельла) аҟынтәи ишәоуз  авидео аҳаракыра
The height of the widget when toplevel in the GladeDesignLayout	Авиджет аҳаракыра  ихадоу аԥенџьыр GladeDesignLayout ианатәу
The height of the window	Аԥенџьыр аҳаракыра
the jack of clubs	валет треф
the jack of diamonds	валет бубен
the jack of hearts	Афурҭ агәыҟаԥшь
the jack of spades	валет пик
The --list-properties argument can only be empty when used with the --tree argument	Аҵаҵӷәы --list-properties иҭацәызар ҟалоит аҵаҵӷәы --tree заҵәык ахархәараан
Theme _variant:	_Атема авариант:
The pango attributes for this label	Аҟазшьарбагақәа pango  ари адырга азы
The profile has the following problems:	Аҷыдахәра иамоуп анаҩстәи  агхақәа
  There are no items to show in this view.  Double-click here to create a new Contact.	Иҟаӡам аелементқәа   ари аԥенџьыр аҟны иаарԥшразы. Ҩынтә абраҟа шәақәыӷәӷәа аимадара ҿыц аԥҵаразы
  There are no items to show in this view.	Иҟаӡам аелементқәа   ари аԥенџьыр аҟны иаарԥшразы
The second timezone for a Day View	Аҩынтәтәи асааҭзона амш ахҳәааҟны
The side of the board that is in the foreground	Иааигәаны иҟоу аӷәы аган
The unit used by RGB component and strings.	Аидкыла,  ацәаҳәақәеи RGB ахәҭеи ахархәара азызуа .
The white is not D50 white	Аԥштәы шкәакәа  еиԥшӡам ашкәакәа  D50 
The window’s height in pixels	Аԥенџьыр аҳаракыра пиксельла
This was the third time you entered a wrong password. Please try again.	Хынтә ииашам ажәамаӡа ҭажәҩит .Еиҭа шәҽазышәшәа.
Tile View	Адыргаҷақәа  рыԥшра рыҭаны
Times	Аамҭа
time	Аамҭа
Time	Аамҭа
Timor-Leste	Амрагыларатәи Тимор
TLS backend does not implement TLS binding retrieval	Абиблиотека TLS инанагӡаӡом адгалара TLS binding ахь
TODO/FIXMEs	TODO/FIXME
Toggle the silencing of speech	 Аамҭала ацәажәара аҿакра, мамзар аҿыхра
Top Bar	Хыхьтәи апанель
Top Bin	Хыхьтәи аконтеинер
Top Half	Хыхьтәи абжара
Top Left	Хыхьтәи армаратәи
Toplevel Height	Ихадоу аԥенџьыр аҳаракыра
Toplevel	Иреиҳаӡоу аҩаӡара
_Top of window	_Аԥенџьыр ақәцә
Top of window	Аԥенџьыр ақәцә
top	хыхь
Top	Хыхь
_Top:	_Хыхьтәи:
translator-credits	Александр Кострикин Валек Филиппов aka frob Дмитри Мастрюков Вячеслав Диконов Михаил Иахонтов Леонид Кантер Ser82-png, 2022
translator-credits	Валек Филиппов <frob@df.ru> Сергеи Сафонов <spoof@spoofa.info> Юри Миасоедов <ymyasoedov@yandex.ru>, 2014. Alexey Rubtsov <rushills@gmail.com>, 2021
Tree View Attributes	аҵла аҟазшьарбагақәа
true	иаҿакуп
Tuesday is a work day	Аҩаша - аусура амш
Tuesday	Аҩаша
_Tue	_Аҩ
Tue	Аҩ
turquoise	ахаҳәиаҵәатә
Tu	Аҩ
T	Аҟны
T	Аҩ
U.K. English Grade 1	Британиатәи  англиски аҩаӡара 1
U.K. English Grade 2	Британиатәи  англиски аҩаӡара 2
Unicase	Аихшагада
Unnamed (%s).img	Хьӡыда (%s).img
(unnamed)	(хьӡыда)
Unnamed	Хьӡыда
Untagged	Дыргада
unversioned	версиада
Upper total	Хыхьтәи аицҵалыҵ 
Upper:	Хыхьтәи :
uri: %s 	uri: %s 
U.S. English Grade 1	Англызбызшәа аҩаӡара 1
U.S. English Grade 2	Англызбызшәа аҩаӡара 2
UUIDs of extensions to enable	UUID иаҿаку ахкырбагақәа
Vacaville	Вакавиль
Vadsø	Вадсио
Vaduz	Вадуз
Vai	Ваи
Valdez	Валдес
Val-d'Or	Вал-д-Ор
Valdosta	Валдоста
Valencia	Валенсиа
Valentine	Валентаин
Valentine	Валентин
Valera	Валера
Valladolid	Валиадолид
Vallejo	Валлеио
Valletta	Валетта
Valley	Валле
Val Marie	Вал-Мари
Valparaiso	Вальпараисо
Vamdrup	Вамдруп
Vancouver	Ванкувер
Van Nuys	Ван Наис
Vantaa	Вантаа
Vanuatu	Вануату
Van	Ван
Varennes	Вареннес
Varese	Варесе
variant	авариант
Variant	Авариант
Varkaus	Варкаус
Varna	Варна
Västerås	Вестерос
Vatican City	Ватикан
Vattu Variants	Авариантқәа ватту
Vattu Variants	Авариантқәа Ватту
Växjö	Векше
Vector Graphics	Аҵәырхатә графика
Vegreville	Вегревиль
Velikiye Luki	Великие Луки
Vélizy	Велизи
Venezuelan Bolívar	Венесуелатәи боливар фуерте
Venezuela	Венесуела
Venice	Венециа
Ventura	Вентура
Veracruz	Веракрус
Verbania	Вербаниа
Vercelli	Верчелли
Vereeniging	Вереенигинг
Vermont	Вермонт
Vernal	Вернал
Vernon	Вернон
Version 0	Аверсиа 1
Version 1	Аверсиа 2
Version of this application	Ари аԥшьы аверсиа
Version %s	Аверсиа %s
version	аверсиа
Version	Аверсиа
Version:	Аверсиа:
Vertical Alignment	Гәҵәыла  аиҟаратәра
vertical align	Гәҵәыла  аиҟаратәра
vertical bar	агәҵәытә цәаҳәа
Vertical Button Box	Агәҵәытә пытҟәырқәа ргәыԥ
vertical ellipsis	Гәҵәылатәи акәаԥрацәа 
Vertical Kerning	Гәҵәыла кернинг
_Vertical Layout	_Гәҵәыла аҭыԥыркра
Vertical Panes	Агәҵәытә панель
Vertical Scale	Агәҵәытә аихшарба
vertical scroll bar	Гәҵәылатәи аҭаргьежьга цәаҳәа
Vertical Scrollbar	Гәҵәылатәи аҭаргьежьга цәаҳәа
Vertical Writing	Гәҵәыла аҩышьа
Vertical Writing	Гәҵәылатәи ацҳамҭа
vertical	агәҵәытә
Vertical	Гәҵәыла
Vertical	Гәҵәылатәи
Vibo Valentia	Вибо Валенциа
Video DVD	DVD-Video
Video height	Авидео аҳаракыра
Videos	Авидео
video	Авидео
_Video	_Авидео
Video	Авидео
Vienna	Вена
View as type	Аԥшра
View as	Аԥшра
_View	_Аԥшра
View	Аԥшра
Vigie	Виги
Vigo	Виго
volcanic ash	авулкан аццышә
Volcanic ash	Авулкан аццышә
Vršac	Вршац
Vulkan API version	Аверсиа API Vulkan
Wabush	Вабуш
Wadena	Вадена
Wadesboro	Вадесборо
Wahiawā	Вахиава
Wahpeton	Вахпетон
Waiki‘i	Ваикии
WakeUp	Ицәоу арежим аҟынтә аҭыҵра
Wakkanai	Вакканаи
Wallis and Futuna	Валлиси Фотунеи
Warang Citi	Варанг Сити
Warren	Варрен
Warsaw	Варшава
Washington	Вашингтон
Waterloo	Ватерлоо
Watrous	Ватрус
Wawa	Вава
Weatherford	Везерфорд
Webershausen	Вебершаузен
Web pages	Веб-адаҟьа
_Web page:	_Веб-адаҟьа :
Web Page	Веб-адаҟьа
Web Page:	Веб-адаҟьа:
Web service	Веб-асервис
Website	Веб-адаҟьа
Website:	Веб-асаит:
Website	Веб-асаит абраузера
WebSQL databases	Адыррақәа рбаза WebSQL
weight	Акапан
Weight	Акапан
Wellington	Веллингтон
Welsh Grade 1	Валлиатә аҩаӡара 1
Welsh Grade 2	Валлиатә аҩаӡар 2
Westerland	Вестерланд
Westhampton Beach	Вестхемптон
Westminster	Вестминстер
Westport	Вестпорт
Weyburn	Веибурн
Wharton	Вартон
Wha Ti	Ва-Ти
Whether edge scrolling is enabled	Иаҿакума аҿацәтә ҭаргьежьга
Whether or not postprocessing is enabled	Иаҿаку иаҿакыму ашьҭахьтәи аус адулара
Whether or not postprocessing is enabled.	Иаҿаку иаҿакыму ашьҭахьтәи аус адулара
Whether the “Bounce Keys” keyboard accessibility feature is turned on.	Иаҿакума арыдыркыра азы иадҟьо арыдқәа иҷыдоу рылшара .
Whether the “Mouse Keys” accessibility feature is turned on.	Иаҿакума арыдқәа рыцхыраарала аҳәынаԥ анапхгара аҭара иҷыдоу алшара 
Whether the on-screen keyboard is turned on.	Иаҿакума аекрантә рыдыркыра 
Whether the privacy screen is enabled	Иаҿакума аекран амаӡара
Whether the RDP backend is enabled or not	Иаҿаку иаҿакыму бэкэнд RDP
Whether the screen magnifier is turned on.	Иаҿакума аекрантә  рдуга
Whether the shell integration is enabled	Иаҿакума ахарԥа  адҵара
Whether the “Slow Keys” accessibility feature is turned on.	Иаҿакума имыццакуа арыдқәа иҷыдоу рылшара 
Whether the text-highlight module is enabled	Иаҿакума атекст алкаара  амодуль
Whether the “Toggle Keys” accessibility feature is turned on.	Иаҿакума аиагаратә рыдқәа иҷыдоу рылшара
Whether the VNC backend is enabled or not	Иаҿаку иаҿакыму бэкэнд VNC
Whether two-finger scrolling is enabled	Иаҿакума ҩ-нацәак рыла аҭаргьежьга
White bishop at %1$s takes the black bishop at %2$s	Аслан шкәакәа  %1$s аслан еиқәаҵәа агоит %2$s аҟны
White bishop at %1$s takes the black knight at %2$s	Аслан шкәакәа  %1$s аҽы еиқәаҵәа агоит %2$s аҟны
White bishop at %1$s takes the black pawn at %2$s	Аслан  шкәакәа  %1$s апешка еиқәаҵәа агоит %2$s аҟны
White bishop at %1$s takes the black queen at %2$s	Аслан  шкәакәа  %1$s аферз еиқәаҵәа агоит %2$s аҟны
White bishop at %1$s takes the black rook at %2$s	Аслан  шкәакәа  %1$s абааш еиқәаҵәа агоит %2$s аҟны
White bishop moves from %1$s to %2$s	Аслан  шкәакәа %1$s аҟынтәи  %2$s ахь ииасоит
White captured Black's pawn <span font_style='italic'>en passant</span>.	Ашкәакәақәа Аиқәаҵәақәа рпешка ргеит<span font_style='italic'>на проходе</span>.
White castles kingside	Ашкәакәақәа икьаҿу арокировка ҟарҵоит
White castles queenside	Ашкәакәақәа иау арокировка ҟарҵоит
Whitehead	Ахы шкәакәа
White is in check and cannot move.	Ашкәакәақәа шах аҵаҟа иҟоуп уи азы изныҟәаӡом
White is in Check	Ашкәакәақәа шах аҵаҟа иҟоуп.
White is Thinking…	Ашкәакәақәа хәыцоит...
White king at %1$s takes the black bishop at %2$s	Аҳ шкәакәа  %1$s аслан еиқәаҵәа агоит %2$s аҟны
White king at %1$s takes the black knight at %2$s	Аҳ шкәакәа  %1$s аҽы еиқәаҵәа агоит %2$s аҟны
White king at %1$s takes the black pawn at %2$s	Аҳ шкәакәа  %1$s апешка еиқәаҵәа агоит %2$s аҟны
White king at %1$s takes the black queen at %2$s	Аҳ шкәакәа  %1$s аферз еиқәаҵәа агоит %2$s аҟны
White king at %1$s takes the black rook at %2$s	Аҳ шкәакәа  %1$s абааш еиқәаҵәа агоит %2$s аҟны
White king moves from %1$s to %2$s	Аҳ шкәакәа %1$s аҟынтәи  %2$s ахь ииасоит
White knight at %1$s takes the black bishop at %2$s	Аҽы шкәакәа  %1$s аслан еиқәаҵәа агоит %2$s аҟны
White knight at %1$s takes the black knight at %2$s	Аҽы шкәакәа  %1$s аҽы еиқәаҵәа агоит %2$s аҟны
White knight at %1$s takes the black pawn at %2$s	Аҽы шкәакәа  %1$s апешка еиқәаҵәа агоит %2$s аҟны
White knight at %1$s takes the black queen at %2$s	Аҽы шкәакәа  %1$s аферз еиқәаҵәа агоит %2$s аҟны
White knight at %1$s takes the black rook at %2$s	Аҽы шкәакәа  %1$s абааш еиқәаҵәа агоит %2$s аҟны
White knight moves from %1$s to %2$s	Аҽы шкәакәа  %1$s аҟынтәи  %2$s ахь ииасоит
White list of additional plugins to use	«Ашкәакәа» ахархәаразы иацҵаны амодульқәа  рыхьӡынҵа
_White on black:	_Ашкәакәа аиқәаҵәа аҟны:
White on black	Ашкәакәа аиқәаҵәа аҟны
White pawn at %1$s takes the black bishop at %2$s	Апешка шкәакәа  %1$s аслан еиқәаҵәа агоит  %2$s аҟны
White pawn at %1$s takes the black knight at %2$s	Апешка шкәакәа  %1$s аҽы еиқәаҵәа агоит  %2$s аҟны
White pawn at %1$s takes the black pawn at %2$s en passant	Апешка шкәакәа  %1$s апешка еиқәаҵәа агоит  %2$s аҟны абжьысраҟны
White pawn at %1$s takes the black pawn at %2$s	Апешка шкәакәа  %1$s апешка еиқәаҵәа агоит  %2$s аҟны
White pawn at %1$s takes the black queen at %2$s	Апешка шкәакәа  %1$s аферз еиқәаҵәа агоит  %2$s аҟны
White pawn at %1$s takes the black rook at %2$s	Апешка шкәакәа  %1$s абааш еиқәаҵәа агоит  %2$s аҟны
White pawn moves from %1$s to %2$s	Апешка шкәакәа ииасоит  %1$s аҟынтә  %2$s ахь
White point	Акәаԥ шкәакәа
White queen at %1$s takes the black bishop at %2$s	Аферз шкәакәа  %1$s аслан еиқәаҵәа агоит %2$s аҟны
White queen at %1$s takes the black knight at %2$s	Аферз шкәакәа  %1$s аҽы еиқәаҵәа агоит %2$s аҟны
White queen at %1$s takes the black pawn at %2$s	Аферз  шкәакәа  %1$s апешка еиқәаҵәа агоит %2$s аҟны
White queen at %1$s takes the black queen at %2$s	Аферз  шкәакәа  %1$s аферз еиқәаҵәа агоит %2$s аҟны
White queen at %1$s takes the black rook at %2$s	Аферз  шкәакәа  %1$s абааш еиқәаҵәа агоит %2$s аҟны
White queen moves from %1$s to %2$s	Аферз  шкәакәа %1$s аҟынтәи  %2$s ахь ииасоит
White rook at %1$s takes the black bishop at %2$s	Абааш шкәакәа  %1$s аслан еиқәаҵәа агоит  %2$s аҟны
White rook at %1$s takes the black knight at %2$s	Абааш шкәакәа  %1$s аҽы еиқәаҵәа агоит  %2$s аҟны
White rook at %1$s takes the black pawn at %2$s	Абааш шкәакәа  %1$s апешка еиқәаҵәа агоит  %2$s аҟны
White rook at %1$s takes the black queen at %2$s	Абааш шкәакәа  %1$s аферз еиқәаҵәа агоит  %2$s аҟны
White rook at %1$s takes the black rook at %2$s	Абааш шкәакәа  %1$s абааш еиқәаҵәа агоит  %2$s аҟны
White rook moves from %1$s to %2$s	Абааш шкәакәа ииасоит  %1$s аҟынтә  %2$s ахь
White Wins	Ашкәакәақәа аиааира ргеит
White	Ашкәакәақәа
Widget Attributes	Авиджет аҟазшьарбагақәа
Window Attributes	Аԥенџьыр аҟазшьарбагақәа
Window height	Аԥенџьыр аҳаракыра
Windows animated cursor	Ианимациарку ахырхага Windows
Wired 802.1X authentication	Ахаҭареилкаара Wired 802.1X
Wireless device does not support Hotspot mode	Иҭелдоу аиҿартәыра анеира аҭыԥ арежим аднакылаӡом
Wireless keyboard	Иҭелдоу арыдыркыра
Wireless mouse	Иҭелдоу аҳәынаԥ
Wireless networking is disabled	Иҭелдоу аҳатә еимадара аҿыхуп
Wireless Wan is disabled when airplane mode is on	Иҭелдоу аҳақәа аҿыххоит авиарежим анаҿаку
) without opening (	) иаазыртуа ада (
Without Sound	Бжьыда
Woensdrecht	Вунсдрехт
Wolf Point	Вулф-Поинт
Woodruff	Вудруф
Woomera	Вумера
Wooster	Вустер
W_orried	Згәы ҭ_ынчым
Would you like to send a cancellation notice for this memo?	Ари азгәаҭа аԥыхра иазкны адырра шәышьҭыр шәҭахума?
Wunstorf	Вунсторф
Wyoming	Ваиоминг
Yesterday, %1$s – %2$s	Иацы, %1$s – %2$s
Yesterday %H:%M	Иацы%H:%M
Yesterday, %H∶%M	Иацы, %H∶%M
Yesterday %H∶%M	Иацы в %H∶%M
Yesterday %I∶%M %p	Иацы в %I∶%M %p
Yesterday %l∶%M %p	Иацы%H:%M
Yesterday %l:%M %p	Иацы%l:%M %p
Yesterday, %l∶%M %p	Иацы, %-l∶%M %p
Yesterday %s	Иацы%s
yesterday	Иацы
Yesterday	Иацы
You are modifying a recurring event. What would you like to modify?	Шәара еиҭаҟало  ахҭыс шәыԥсахоит. Иарбан ишәыԥсахҵәҟьар ишәҭаху?
You are modifying a recurring memo. What would you like to modify?	Шәара еиҭаҟало  азгәаҭа шәыԥсахоит. Иарбан ишәыԥсахҵәҟьар ишәҭаху?
You are modifying a recurring task. What would you like to modify?	Шәара еиҭаҟало  аҳасабтә шәыԥсахоит. Иарбан ишәыԥсахҵәҟьар ишәҭаху?
You are not allowed to open this file.	Ари афаил аартра азин шәымаӡам
You are searching for a five.	Шәара хәба шәашьҭоуп
You are searching for a four.	Шәара ԥшьба  шәашьҭоуп
You are searching for a jack.	Шәара валет шәашьҭоуп.
You are searching for a king.	Шәара аҳ шәишьҭоуп
You are searching for an ace.	Шәара туз шәашьҭоуп
You are searching for an eight.	Шәара ааба шәашьҭоуп
You are searching for a nine.	Шәара жәба шәашьҭоуп
You are searching for a queen.	Шәара аӡӷаб шәлышьҭоуп.
You are searching for a seven.	Шәара бжьба шәашьҭоуп
You are searching for a six.	Шәара фба  шәашьҭоуп
You are searching for a ten.	Шәара жәаба шәашьҭоуп
You are searching for a three.	Шәара хԥа шәашьҭоуп
You are searching for a two.	Шәара  ҩба шәашьҭоуп
You are using a preview of Books. Full viewing capabilities are coming soon!	Шәара шәхы иашәырхәоит ашәҟәы заанаҵтәи аверсиа.Инаӡоу алшарақәа реизга хара имгакәа ицәырҵуеит!
You have completed the game.	Ахәмарра шәахысит.
You have the Caps Lock key on.	Caps Lock аҿакуп.
You may need to select different mail options.  Detailed error: {0}	Шәара аԥошьҭа егьырҭ ахышәарақәа  азалшәхыр акәхоит.  Амзыз: {0}
You reached the maximum authentication attempts, please try another method	Шәара шәхы иашәырхәеит  аҭаларазы аҽазышәарақәа зегьы,  ҳшәыҳәоит даҽа методк шәхы иашәырхәарц
You reached the maximum auto login attempts, please try another authentication method	Шәара шәхы иашәырхәеит автоматикла аҭаларазы аҽазышәарақәа зегьы,  ҳшәыҳәоит даҽа методк шәхы иашәырхәарц.
You reached the maximum fingerprint authentication attempts, please try another method	Шәара шәхы иашәырхәеит анацәа ашьҭа ала аҭаларазы аҽазышәарақәа зегьы,  ҳшәыҳәоит даҽа методк шәхы иашәырхәарц
You reached the maximum password authentication attempts, please try another method	Шәара шәхы иашәырхәеит ажәамаӡала аҭаларазы аҽазышәарақәа зегьы,  ҳшәыҳәоит даҽа методк шәхы иашәырхәарц
You reached the maximum smart card authentication attempts, please try another method	Шәара шәхы иашәырхәеит смарт-ахсаала ала аҭаларазы аҽазышәарақәа зегьы,  ҳшәыҳәоит даҽа методк шәхы иашәырхәарц
You’ve won in a time of %02u:%02u!	Шәара аиаара шәгеит %02u:%02u! рыла!
You will be notified when the download has completed.	Аҭагалара анхырқәшахалак ашьҭахь шәара адырра шәоуоуит
