editor/about-list.vala:135	GNU General Public Licensenewlineversion 3 or later	GNU General Public Licensenewlineаверсиа 3 мамзар еиҳа ихьшәоу 
src/eog-util.c:515	%i × %i pixelnewlinemsgid_plural: %i × %i pixels	msgstr[0]: %i × %i пикселькnewlinemsgstr[1]: %i × %i пикселькnewlinemsgstr[2]: %i × %i пиксельк
src/eog-window.c:546	%i × %i pixel  %s    %i%%newlinemsgid_plural: %i × %i pixels  %s    %i%%	msgstr[0]: %i × %i пиксельк  %s    %i%%newlinemsgstr[1]: %i × %i пиксельк  %s    %i%%newlinemsgstr[2]: %i × %i пиксельк  %s    %i%%
backend/pdf/ev-poppler.c:1026	%s%snewlineEncoding: %snewline%snewlineSubstituting with <b>%s</b>newline(%s)	%s%snewlineАкодркра: %snewline%s иԥсахуа  <b>%s</b> аҟынтә %s 
backend/pdf/ev-poppler.c:1044	%s%snewlineEncoding: %snewline%s	%s%snewlineАкодркра: %snewline%s
../src/addressbook/gui/widgets/e-minicard-view.c:186	newlinenewlineSearching for the Contacts…	Аимадарақәа рыԥшаара...
../src/addressbook/gui/widgets/e-minicard-view.c:189	newlinenewlineSearch for the Contactnewlinenewlineor double-click here to create a new Contact.	Ишәыԥшаа аимадара , мамзар абраҟа шәақәыӷәӷәа аҿыц аԥҵаразы
../src/addressbook/gui/widgets/e-minicard-view.c:192	newlinenewlineThere are no items to show in this view.newlinenewlineDouble-click here to create a new Contact.	Иҟаӡам аелементқәа   ари аԥенџьыр аҟны иаарԥшразы. Ҩынтә абраҟа шәақәыӷәӷәа аимадара ҿыц аԥҵаразы
../src/addressbook/gui/widgets/e-minicard-view.c:196	newlinenewlineSearch for the Contact.	Аимадара аԥшаара.
../src/addressbook/gui/widgets/e-minicard-view.c:198	newlinenewlineThere are no items to show in this view.	Иҟаӡам аелементқәа   ари аԥенџьыр аҟны иаарԥшразы
../src/mail/importers/kmail-importer.c:259	%d Addressnewlinemsgid_plural: %d Addresses	msgstr[0]: %d ҭыӡҭыԥкnewlinemsgstr[1]: %d ҭыӡҭыԥкnewlinemsgstr[2]: %d ҭыӡҭыԥк
../src/mail/mail.error.xml.h:18	The following recipient was not recognized as a valid mail address:newline{0}	Анаҩстәи адкылаҩ иԥошьҭа аиашашьа еилкаамхазеит :newline{0}
../src/mail/mail.error.xml.h:21	The following recipients were not recognized as valid mail addresses:newline{0}	Анаҩстәи адкылаҩцәа рԥошьҭақәа риашашьа еилкаамхазеит :newline{0}
../src/shell/shell.error.xml.h:3	{0}newlinenewlineIf you choose to continue, you may not have access to some of your old data.newline	{0}newlinenewlineИацышәҵар шәҭахызар, ажәытә дыррақәа ԥыҭк  рахь  анеира азин шәцәыӡыр шәылшоитnewline
src/glade.glade:311	<small>In memory of an extraordinarynewlineperson and professornewlineR.I.P Guido Macchi</small>	<small> Зеиԥш дҟамлац ауаҩԥси апрофессори игәаларшәара иазкны R.I.P. Гвидо Маки</small>
src/glade.glade:848	© 2018-2020 Juan Pablo Ugarte, et al.newline© 2004-2018 Tristan Van Berkom, Juan Pablo Ugarte, et al.newline© 2001-2006 Joaquin Cuenca Abela, Paolo Borelli, et al.newline© 2001-2006 Ximian, Inc.	© 2018-2020 Хуан Пабло Угарте (Juan Pablo Ugarte) уб.егь.newline© 2004-2018 Тристан Ван Берком (Tristan Van Berkom), Хуан Пабло Угарте (Juan Pablo Ugarte) уб.егь.newline© 2001-2006 Joaquin Cuenca Abela, Paolo Borelli, уб.егь.newline© 2001-2006 Ximian, Inc.
src/glade-preferences.glade:106 src/glade-preferences.glade:121 src/glade-preferences.glade:140	Automatically save the project to an alternate file whenevernewlinethe project is modified and the specified timeout elapses	Автоматикла апроект даҽа фаилк ахь лассы-лассы аиқәырхара  , апроект аԥсахраангьы. 
gladeui/glade-base-editor.c:2156	<big><b>Tips:</b></big>newline  * Right-click over the treeview to add items.newline  * Press Delete to remove the selected item.newline  * Drag &amp; Drop to reorder.newline  * Type column is editable.	<big><b>Аҵаҳәарақәа:</b></big>newline  * Аҵлаҟны  аелемент ацҵаразы , аҵла аҵаҟа аҳәынапԥ арыӷьаратәи пытҟәыр шәақәыӷәӷәа.newline  * Иалкаау аелементқәа рныхразы шәақәыӷәӷәа Delete.newline  * Аелеменқәа реишьҭагылашьа аԥсахразы еиҭажәга урҭ аҳәынаԥ ала.newline  * Ахкы аиҵагыла ариашара ҟалоит.
gladeui/glade-previewer-main.c:332	%snewlineRun '%s --help' to see a full list of available command line options.newline	%snewlineАус ашәыруы  «%s --help» анеиразин ахьшәымоу адҵатә ҵәаҳәа  ахышәарақәа рыхҩылаақәа зегьы рыхәаԥшразы.newline
gladeui/glade-project.c:2057	An automatically saved version of `%s' is more recent.newlinenewlineWould you like to load the autosave version instead?	Автоматикла еиқәырхоу аверсиа "%s"  еиҳа иҿыцуп. newlinenewlineИшәҭахума шәара иара ацынхәрас автоматикла аиқәырхара змоу аверсиа ҭажәгалар. 
gladeui/glade-project.c:3056	[%s]Object class '<b>%s</b>' was introduced in %s %d.%d	newlinenewline[%s] Аобиект акласс '<b>%s</b>' ҭагалан %s %d.%d ахь
gladeui/glade-project.c:3061	[%s]Object class '<b>%s</b>' from %s %d.%d is deprecated	[%s]newlineАобиект акласс '<b>%s</b>' %s %d.%d аҟынтә иажәхьеит
gladeui/glade-project.c:3070	[%s]Property '<b>%s</b>' of object class '<b>%s</b>' was introduced in %s %d.%d	[%s]newlineАҷыдаҟазшьа «<b>%s</b>» аобиект «<b>%s</b>» акласс  иаҵанакуа ҭагалан %s %d.%d ахь
gio/gio-tool-info.c:168	uri: %snewline	uri: %snewline
glib/gutils.c:2947	bytenewlinemsgid_plural: bytes	msgstr[0]: баиткnewlinemsgstr[1]: баиткnewlinemsgstr[2]: баитк
glib/gutils.c:3046	%s bytenewlinemsgid_plural: %s bytes	msgstr[0]: %s баиткnewlinemsgstr[1]: %s баиткnewlinemsgstr[2]: %s баитк
glib/gutils.c:3092	%u bytenewlinemsgid_plural: %u bytes	msgstr[0]: %u баиткnewlinemsgstr[1]: %u баиткnewlinemsgstr[2]: %u баитк
src/gui/event-editor/gcal-alarm-row.c:84	%1$u day, %2$u hour, and %3$u minute beforenewlinemsgid_plural: %1$u day, %2$u hour, and %3$u minutes before	msgstr[0]: %1$u ҽнаки, %2$u сааҭки %3$u минуҭки ҟалаанӡаnewlinemsgstr[1]: %1$u ҽнаки, %2$u сааҭки %3$u минуҭки  ҟалаанӡаnewlinemsgstr[2]: %1$u ҽнаки, %2$u сааҭки %3$u минуҭки ҟалаанӡа
src/gui/event-editor/gcal-alarm-row.c:88	%1$u day, %2$u hours, and %3$u minute beforenewlinemsgid_plural: %1$u day, %2$u hours, and %3$u minutes before	msgstr[0]: %1$u ҽнаки, %2$u сааҭки %3$u минуҭ ки ҟалаанӡаnewlinemsgstr[1]: %1$u ҽнаки, %2$u сааҭки %3$u минуҭки  ҟалаанӡаnewlinemsgstr[2]: %1$u ҽнаки, %2$u сааҭки %3$u минуҭки ҟалаанӡа
src/gui/event-editor/gcal-alarm-row.c:94	%1$u days, %2$u hour, and %3$u minute beforenewlinemsgid_plural: %1$u days, %2$u hour, and %3$u minutes before	msgstr[0]: %1$u мши, %2$u сааҭки, и %3$u минуҭки ҟалаанӡаnewlinemsgstr[1]: %1$u мши, %2$u сааҭки, и %3$u минуҭки ҟалаанӡаnewlinemsgstr[2]: %1$u мши, %2$u сааҭки, и %3$u минуҭки ҟалаанӡа
src/gui/event-editor/gcal-alarm-row.c:98	%1$u days, %2$u hours, and %3$u minute beforenewlinemsgid_plural: %1$u days, %2$u hours, and %3$u minutes before	msgstr[0]: %1$u мши, %2$u сааҭки, и %3$u минуҭки ҟалаанӡаnewlinemsgstr[1]: %1$u мши, %2$u сааҭки, и %3$u минуҭки ҟалаанӡаnewlinemsgstr[2]: %1$u мши, %2$u сааҭки, и %3$u минуҭки ҟалаанӡа
src/gui/event-editor/gcal-alarm-row.c:113	%1$u day and %2$u hour beforenewlinemsgid_plural: %1$u day and %2$u hours before	msgstr[0]: %1$u ҽнаки и %2$u сааҭки ҟалаанӡаnewlinemsgstr[1]: %1$u ҽнаки %2$u сааҭки ҟалаанӡаnewlinemsgstr[2]: %1$u ҽнаки %2$u сааҭки ҟалаанӡа
src/gui/event-editor/gcal-alarm-row.c:117	%1$u days and %2$u hour beforenewlinemsgid_plural: %1$u days and %2$u hours before	msgstr[0]: %1$u мши %2$u сааҭки ҟалаанӡаnewlinemsgstr[1]: %1$u мши %2$u сааҭки ҟалаанӡаnewlinemsgstr[2]: %1$u мши %2$u сааҭки ҟалаанӡа
src/gui/event-editor/gcal-alarm-row.c:133	%1$u day and %2$u minute beforenewlinemsgid_plural: %1$u day and %2$u minutes before	msgstr[0]: %1$u ҽнаки %2$u минуҭки ҟалаанӡаnewlinemsgstr[1]: %1$u ҽнаки %2$u минуҭки ҟалаанӡаnewlinemsgstr[2]: %1$u ҽнаки %2$u минуҭки ҟалаанӡа
src/gui/event-editor/gcal-alarm-row.c:137	%1$u days and %2$u minute beforenewlinemsgid_plural: %1$u days and %2$u minutes before	msgstr[0]: %1$u мши и %2$u минуҭки ҟалаанӡаnewlinemsgstr[1]: %1$u мши и %2$u минуҭки ҟалаанӡаnewlinemsgstr[2]: %1$u мши и %2$u минуҭки ҟалаанӡа
src/gui/event-editor/gcal-alarm-row.c:147	%1$u day beforenewlinemsgid_plural: %1$u days before	msgstr[0]: %1$u ҽнак шагоуnewlinemsgstr[1]: %1$u мшы шагоуnewlinemsgstr[2]: %1$u мшы шагоу
src/gui/event-editor/gcal-alarm-row.c:179	%1$u hour beforenewlinemsgid_plural: %1$u hours before	msgstr[0]: %1$u сааҭк иҟалаанӡаnewlinemsgstr[1]: %1$u сааҭк иҟалаанӡаnewlinemsgstr[2]: %1$u сааҭк иҟалаанӡа
src/gui/event-editor/gcal-alarm-row.c:191	%1$u minute beforenewlinemsgid_plural: %1$u minutes before	msgstr[0]: %1$u минуҭк ҟалаанӡаnewlinemsgstr[1]: %1$u минуҭк ҟалаанӡаnewlinemsgstr[2]: %1$u минуҭк ҟалаанӡа
src/contacts-app.vala:171	© 2011 Red Hat, Inc.newline© 2011-2020 The Contacts Developers	© 2011 Red Hat, Inc.newline© 2011-2020 Аимадарақәа рыҟаҵаҩцәа
src/disks/gduapplication.c:348	gnome-disk-utility %snewlineUDisks %s (built against %d.%d.%d)	gnome-disk-utility %snewlineUDisks %s (аизга %d.%d.%d аҟынтә)
src/disks/ui/about-dialog.ui:11	Copyright © 2008-2013 Red Hat, Inc.newlineCopyright © 2008-2013 David ZeuthennewlineCopyright © 2009-2017 The GNOME Projectnewline	Аԥҵаҩы изин © 2008-2013 Red Hat, Inc.newlineАԥҵаҩы изин © 2008-2013 David ZeuthennewlineАԥҵаҩы изин © 2009-2017 The GNOME Projectnewline
src/gnome-mines.vala:301	%d × %d, %d minenewlinemsgid_plural: %d × %d, %d mines	msgstr[0]: %d × %d, %d аминаnewlinemsgstr[1]: %d × %d, %d минакnewlinemsgstr[2]: %d × %d, %d минак
src/gnome-mines.vala:452	<b>%d</b> minenewlinemsgid_plural: <b>%d</b> mines	msgstr[0]: <b>%d</b> минакnewlinemsgstr[1]: <b>%d</b> минакnewlinemsgstr[2]: <b>%d</b> минак
src/photos-main-window.c:458	Copyright © 2012 – 2021 Red Hat, Inc.newlineCopyright © 2015 – 2018 Umang Jain	Аԥҵаҩы изин © 2012 – 2021 Red Hat, Inc.newlineАԥҵаҩы изин © 2015 – 2018 Umang Jain
src/photos-properties-dialog.c:656	%ld × %ld pixelnewlinemsgid_plural: %ld × %ld pixels	msgstr[0]: %ld × %ld пикселькnewlinemsgstr[1]: %ld × %ld пикселькnewlinemsgstr[2]: %ld × %ld пиксельк
plugins/wwan/gsd-wwan-manager.c:156	%2$s. You have %1$u try leftnewlinemsgid_plural: %2$s. You have %1$u tries left	msgstr[0]: %2$s. ишәзаанхеит %1$u ҽазышәаракnewlinemsgstr[1]: %2$s. ишәзаанхеит %1$u ҽазышәаракnewlinemsgstr[2]: %2$s. ишәзаанхеит %1$u ҽазышәарак
src/about-list.vala:135	GNU General Public Licensenewlineversion 3 or later	GNU General Public Licensenewlineаверсиа 3 мамзар еиҳа иҿыцу
src/gnome-tetravex.vala:1057	translator-credits	Александр КострикинnewlineВалек Филиппов aka frobnewlineДмитри МастрюковnewlineВячеслав ДиконовnewlineМихаил ИахонтовnewlineЛеонид КантерnewlineSer82-png, 2022
src/plugins/background/gtd-plugin-background.c:238	%1$s and one more tasknewlinemsgid_plural: %1$s and %2$d other tasks	msgstr[0]: %1$s даҽа %2$d ҳасабтәкиnewlinemsgstr[1]: %1$s  даҽа %2$d  ҳасабтәқәеиnewlinemsgstr[2]: %1$sегьырҭ  %2$d  ҳасабтәқәеи
src/about-list.vala:135	GNU General Public Licensenewlineversion 3 or later	GNU General Public Licensenewlineаверсиа 3 мамзар еиҳа иҿыцу 
src/orca/messages.py:2509	%d bytenewlinemsgid_plural: %d bytes	msgstr[0]: %d баиткnewlinemsgstr[1]: %d баиткnewlinemsgstr[2]: %d баитк
pgp/seahorse-gpgme-photos.c:69	<big><b>The photo is too large</b></big>newlineThe recommended size for a photo on your key is %d × %d pixels.	<big><b>Аԥшранҵа амцхә идууп</b></big>newline адгаларатә рышәага аԥшранҵақәа  ацаԥхаҟны — %d × %d акәаԥқәа.
pgp/seahorse-keyserver-sync.c:196	<b>%d key is selected for synchronizing</b>newlinemsgid_plural: <b>%d keys are selected for synchronizing</b>	msgstr[0]: <b>%d ацыԥха алхуп </b> асин-newlineхронтәразыnewlinemsgstr[1]: <b>%d ацыԥха алхуп </b> асин-newlineхронтәразыnewlinemsgstr[2]: <b>%d ацыԥха алхуп  </b> асин-newlineхронтәразы
src/totem-gallery-thumbnailer.c:631	<b>%s</b>: %snewline<b>%s</b>: %d×%dnewline<b>%s</b>: %s	<b>%s</b>: %snewline<b>%s</b>: %d×%dnewline<b>%s</b>: %s
